"","Year","Week","Home","Away","WinningSide","PtsH","PtsA","HAPtsDiff","AVG"
"1",2020,1,"Kansas City Chiefs","Houston Texans","Home",34,20,14,13188
"2",2020,1,"Atlanta Falcons","Seattle Seahawks","Away",25,38,-13,7730
"3",2020,1,"Washington Football Team","Philadelphia Eagles","Home",27,17,10,3000
"4",2020,1,"Baltimore Ravens","Cleveland Browns","Home",38,6,32,2172
"5",2020,1,"New England Patriots","Miami Dolphins","Home",21,11,10,0
"6",2020,1,"Detroit Lions","Chicago Bears","Away",23,27,-4,0
"7",2020,1,"Buffalo Bills","New York Jets","Home",27,17,10,0
"8",2020,1,"Carolina Panthers","Las Vegas Raiders","Away",30,34,-4,5200
"9",2020,1,"Jacksonville Jaguars","Indianapolis Colts","Home",27,20,7,15211
"10",2020,1,"Minnesota Vikings","Green Bay Packers","Away",34,43,-9,12200
"11",2020,1,"Cincinnati Bengals","Los Angeles Chargers","Away",13,16,-3,8562
"12",2020,1,"San Francisco 49ers","Arizona Cardinals","Away",20,24,-4,NA
"13",2020,1,"New Orleans Saints","Tampa Bay Buccaneers","Home",34,23,11,1499
"14",2020,1,"Los Angeles Rams","Dallas Cowboys","Home",20,17,3,0
"15",2020,1,"New York Giants","Pittsburgh Steelers","Away",16,26,-10,0
"16",2020,1,"Denver Broncos","Tennessee Titans","Away",14,16,-2,5257
"17",2020,2,"Cleveland Browns","Cincinnati Bengals","Home",35,30,5,8682
"18",2020,2,"Tennessee Titans","Jacksonville Jaguars","Home",33,30,3,10698
"19",2020,2,"Green Bay Packers","Detroit Lions","Home",42,21,21,0
"20",2020,2,"Indianapolis Colts","Minnesota Vikings","Home",28,11,17,8658
"21",2020,2,"Dallas Cowboys","Atlanta Falcons","Home",40,39,1,25750
"22",2020,2,"Pittsburgh Steelers","Denver Broncos","Home",26,21,5,4984
"23",2020,2,"Philadelphia Eagles","Los Angeles Rams","Away",19,37,-18,0
"24",2020,2,"Chicago Bears","New York Giants","Home",17,13,4,0
"25",2020,2,"Miami Dolphins","Buffalo Bills","Away",28,31,-3,11653
"26",2020,2,"New York Jets","San Francisco 49ers","Away",13,31,-18,0
"27",2020,2,"Tampa Bay Buccaneers","Carolina Panthers","Home",31,17,14,12554
"28",2020,2,"Arizona Cardinals","Washington Football Team","Home",30,15,15,2100
"29",2020,2,"Houston Texans","Baltimore Ravens","Away",16,33,-17,12377
"30",2020,2,"Los Angeles Chargers","Kansas City Chiefs","Away",20,23,-3,0
"31",2020,2,"Seattle Seahawks","New England Patriots","Home",35,30,5,0
"32",2020,2,"Las Vegas Raiders","New Orleans Saints","Home",34,24,10,0
"33",2020,3,"Jacksonville Jaguars","Miami Dolphins","Away",13,31,-18,15211
"34",2020,3,"New York Giants","San Francisco 49ers","Away",9,36,-27,0
"35",2020,3,"New England Patriots","Las Vegas Raiders","Home",36,20,16,0
"36",2020,3,"Cleveland Browns","Washington Football Team","Home",34,20,14,8682
"37",2020,3,"Philadelphia Eagles","Cincinnati Bengals","Home",23,23,0,0
"38",2020,3,"Atlanta Falcons","Chicago Bears","Away",26,30,-4,7730
"39",2020,3,"Minnesota Vikings","Tennessee Titans","Away",30,31,-1,12200
"40",2020,3,"Buffalo Bills","Los Angeles Rams","Home",35,32,3,0
"41",2020,3,"Pittsburgh Steelers","Houston Texans","Home",28,21,7,4984
"42",2020,3,"Los Angeles Chargers","Carolina Panthers","Away",16,21,-5,0
"43",2020,3,"Indianapolis Colts","New York Jets","Home",36,7,29,8658
"44",2020,3,"Seattle Seahawks","Dallas Cowboys","Home",38,31,7,0
"45",2020,3,"Arizona Cardinals","Detroit Lions","Away",23,26,-3,2100
"46",2020,3,"Denver Broncos","Tampa Bay Buccaneers","Away",10,28,-18,5257
"47",2020,3,"New Orleans Saints","Green Bay Packers","Away",30,37,-7,1499
"48",2020,3,"Baltimore Ravens","Kansas City Chiefs","Away",20,34,-14,2172
"49",2020,4,"New York Jets","Denver Broncos","Away",28,37,-9,0
"50",2020,4,"Tampa Bay Buccaneers","Los Angeles Chargers","Home",38,31,7,12554
"51",2020,4,"Houston Texans","Minnesota Vikings","Away",23,31,-8,12377
"52",2020,4,"Detroit Lions","New Orleans Saints","Away",29,35,-6,0
"53",2020,4,"Carolina Panthers","Arizona Cardinals","Home",31,21,10,5200
"54",2020,4,"Miami Dolphins","Seattle Seahawks","Away",23,31,-8,11653
"55",2020,4,"Washington Football Team","Baltimore Ravens","Away",17,31,-14,3000
"56",2020,4,"Dallas Cowboys","Cleveland Browns","Away",38,49,-11,25750
"57",2020,4,"Cincinnati Bengals","Jacksonville Jaguars","Home",33,25,8,8562
"58",2020,4,"Chicago Bears","Indianapolis Colts","Away",11,19,-8,0
"59",2020,4,"Los Angeles Rams","New York Giants","Home",17,9,8,0
"60",2020,4,"Las Vegas Raiders","Buffalo Bills","Away",23,30,-7,0
"61",2020,4,"San Francisco 49ers","Philadelphia Eagles","Away",20,25,-5,NA
"62",2020,4,"Kansas City Chiefs","New England Patriots","Home",26,10,16,13188
"63",2020,4,"Green Bay Packers","Atlanta Falcons","Home",30,16,14,0
"64",2020,5,"Chicago Bears","Tampa Bay Buccaneers","Home",20,19,1,0
"65",2020,5,"Pittsburgh Steelers","Philadelphia Eagles","Home",38,29,9,4984
"66",2020,5,"Baltimore Ravens","Cincinnati Bengals","Home",27,3,24,2172
"67",2020,5,"Washington Football Team","Los Angeles Rams","Away",10,30,-20,3000
"68",2020,5,"Atlanta Falcons","Carolina Panthers","Away",16,23,-7,7730
"69",2020,5,"Houston Texans","Jacksonville Jaguars","Home",30,14,16,12377
"70",2020,5,"Kansas City Chiefs","Las Vegas Raiders","Away",32,40,-8,13188
"71",2020,5,"New York Jets","Arizona Cardinals","Away",10,30,-20,0
"72",2020,5,"San Francisco 49ers","Miami Dolphins","Away",17,43,-26,NA
"73",2020,5,"Cleveland Browns","Indianapolis Colts","Home",32,23,9,8682
"74",2020,5,"Dallas Cowboys","New York Giants","Home",37,34,3,25750
"75",2020,5,"Seattle Seahawks","Minnesota Vikings","Home",27,26,1,0
"76",2020,5,"New Orleans Saints","Los Angeles Chargers","Home",30,27,3,1499
"77",2020,5,"Tennessee Titans","Buffalo Bills","Home",42,16,26,10698
"78",2020,6,"New England Patriots","Denver Broncos","Away",12,18,-6,0
"79",2020,6,"Jacksonville Jaguars","Detroit Lions","Away",16,34,-18,15211
"80",2020,6,"Philadelphia Eagles","Baltimore Ravens","Away",28,30,-2,0
"81",2020,6,"Pittsburgh Steelers","Cleveland Browns","Home",38,7,31,4984
"82",2020,6,"Indianapolis Colts","Cincinnati Bengals","Home",31,27,4,8658
"83",2020,6,"Minnesota Vikings","Atlanta Falcons","Away",23,40,-17,12200
"84",2020,6,"Carolina Panthers","Chicago Bears","Away",16,23,-7,5200
"85",2020,6,"Tennessee Titans","Houston Texans","Home",42,36,6,10698
"86",2020,6,"New York Giants","Washington Football Team","Home",20,19,1,0
"87",2020,6,"Miami Dolphins","New York Jets","Home",24,0,24,11653
"88",2020,6,"Tampa Bay Buccaneers","Green Bay Packers","Home",38,10,28,12554
"89",2020,6,"San Francisco 49ers","Los Angeles Rams","Home",24,16,8,NA
"90",2020,6,"Buffalo Bills","Kansas City Chiefs","Away",17,26,-9,0
"91",2020,6,"Dallas Cowboys","Arizona Cardinals","Away",10,38,-28,25750
"92",2020,7,"Philadelphia Eagles","New York Giants","Home",22,21,1,0
"93",2020,7,"Houston Texans","Green Bay Packers","Away",20,35,-15,12377
"94",2020,7,"Tennessee Titans","Pittsburgh Steelers","Away",24,27,-3,10698
"95",2020,7,"New Orleans Saints","Carolina Panthers","Home",27,24,3,1499
"96",2020,7,"New York Jets","Buffalo Bills","Away",10,18,-8,0
"97",2020,7,"Washington Football Team","Dallas Cowboys","Home",25,3,22,3000
"98",2020,7,"Cincinnati Bengals","Cleveland Browns","Away",34,37,-3,8562
"99",2020,7,"Atlanta Falcons","Detroit Lions","Away",22,23,-1,7730
"100",2020,7,"Las Vegas Raiders","Tampa Bay Buccaneers","Away",20,45,-25,0
"101",2020,7,"Denver Broncos","Kansas City Chiefs","Away",16,43,-27,5257
"102",2020,7,"New England Patriots","San Francisco 49ers","Away",6,33,-27,0
"103",2020,7,"Los Angeles Chargers","Jacksonville Jaguars","Home",39,29,10,0
"104",2020,7,"Arizona Cardinals","Seattle Seahawks","Home",37,34,3,2100
"105",2020,7,"Los Angeles Rams","Chicago Bears","Home",24,10,14,0
"106",2020,8,"Carolina Panthers","Atlanta Falcons","Away",17,25,-8,5200
"107",2020,8,"Green Bay Packers","Minnesota Vikings","Away",22,28,-6,0
"108",2020,8,"Miami Dolphins","Los Angeles Rams","Home",28,17,11,11653
"109",2020,8,"Baltimore Ravens","Pittsburgh Steelers","Away",24,28,-4,2172
"110",2020,8,"Detroit Lions","Indianapolis Colts","Away",21,41,-20,0
"111",2020,8,"Kansas City Chiefs","New York Jets","Home",35,9,26,13188
"112",2020,8,"Buffalo Bills","New England Patriots","Home",24,21,3,0
"113",2020,8,"Cleveland Browns","Las Vegas Raiders","Away",6,16,-10,8682
"114",2020,8,"Cincinnati Bengals","Tennessee Titans","Home",31,20,11,8562
"115",2020,8,"Denver Broncos","Los Angeles Chargers","Home",31,30,1,5257
"116",2020,8,"Seattle Seahawks","San Francisco 49ers","Home",37,27,10,0
"117",2020,8,"Chicago Bears","New Orleans Saints","Away",23,26,-3,0
"118",2020,8,"Philadelphia Eagles","Dallas Cowboys","Home",23,9,14,0
"119",2020,8,"New York Giants","Tampa Bay Buccaneers","Away",23,25,-2,0
"120",2019,1,"Chicago Bears","Green Bay Packers","Away",3,10,-7,61916
"121",2019,1,"Cleveland Browns","Tennessee Titans","Away",13,43,-30,67431
"122",2019,1,"Minnesota Vikings","Atlanta Falcons","Home",28,12,16,66849
"123",2019,1,"Philadelphia Eagles","Washington Redskins","Home",32,27,5,69783
"124",2019,1,"Carolina Panthers","Los Angeles Rams","Away",27,30,-3,72220
"125",2019,1,"New York Jets","Buffalo Bills","Away",16,17,-1,78523
"126",2019,1,"Jacksonville Jaguars","Kansas City Chiefs","Away",26,40,-14,63085
"127",2019,1,"Miami Dolphins","Baltimore Ravens","Away",10,59,-49,63067
"128",2019,1,"Los Angeles Chargers","Indianapolis Colts","Home",30,24,6,31750
"129",2019,1,"Seattle Seahawks","Cincinnati Bengals","Home",21,20,1,68990
"130",2019,1,"Dallas Cowboys","New York Giants","Home",35,17,18,90929
"131",2019,1,"Arizona Cardinals","Detroit Lions","Away",27,27,0,61323
"132",2019,1,"Tampa Bay Buccaneers","San Francisco 49ers","Away",17,31,-14,51898
"133",2019,1,"New England Patriots","Pittsburgh Steelers","Home",33,3,30,65753
"134",2019,1,"New Orleans Saints","Houston Texans","Home",30,28,2,73082
"135",2019,1,"Oakland Raiders","Denver Broncos","Home",24,16,8,52549
"136",2019,2,"Carolina Panthers","Tampa Bay Buccaneers","Away",14,20,-6,72220
"137",2019,2,"Tennessee Titans","Indianapolis Colts","Away",17,19,-2,64509
"138",2019,2,"Cincinnati Bengals","San Francisco 49ers","Away",17,41,-24,47179
"139",2019,2,"Miami Dolphins","New England Patriots","Away",0,43,-43,63067
"140",2019,2,"Pittsburgh Steelers","Seattle Seahawks","Away",26,28,-2,62237
"141",2019,2,"Washington Redskins","Dallas Cowboys","Away",21,31,-10,65488
"142",2019,2,"Detroit Lions","Los Angeles Chargers","Home",13,10,3,61342
"143",2019,2,"Green Bay Packers","Minnesota Vikings","Home",21,16,5,77845
"144",2019,2,"Houston Texans","Jacksonville Jaguars","Home",13,12,1,71793
"145",2019,2,"New York Giants","Buffalo Bills","Away",14,28,-14,74664
"146",2019,2,"Baltimore Ravens","Arizona Cardinals","Home",23,17,6,70627
"147",2019,2,"Oakland Raiders","Kansas City Chiefs","Away",10,28,-18,52549
"148",2019,2,"Los Angeles Rams","New Orleans Saints","Home",27,9,18,71229
"149",2019,2,"Denver Broncos","Chicago Bears","Away",14,16,-2,75937
"150",2019,2,"Atlanta Falcons","Philadelphia Eagles","Home",24,20,4,71601
"151",2019,2,"New York Jets","Cleveland Browns","Away",3,23,-20,78523
"152",2019,3,"Jacksonville Jaguars","Tennessee Titans","Home",20,7,13,63085
"153",2019,3,"New England Patriots","New York Jets","Home",30,14,16,65753
"154",2019,3,"Buffalo Bills","Cincinnati Bengals","Home",21,17,4,68839
"155",2019,3,"Green Bay Packers","Denver Broncos","Home",27,16,11,77845
"156",2019,3,"Kansas City Chiefs","Baltimore Ravens","Home",33,28,5,73465
"157",2019,3,"Dallas Cowboys","Miami Dolphins","Home",31,6,25,90929
"158",2019,3,"Philadelphia Eagles","Detroit Lions","Away",24,27,-3,69783
"159",2019,3,"Indianapolis Colts","Atlanta Falcons","Home",27,24,3,61110
"160",2019,3,"Minnesota Vikings","Oakland Raiders","Home",34,14,20,66849
"161",2019,3,"Arizona Cardinals","Carolina Panthers","Away",20,38,-18,61323
"162",2019,3,"Tampa Bay Buccaneers","New York Giants","Away",31,32,-1,51898
"163",2019,3,"Los Angeles Chargers","Houston Texans","Away",20,27,-7,31750
"164",2019,3,"Seattle Seahawks","New Orleans Saints","Away",27,33,-6,68990
"165",2019,3,"San Francisco 49ers","Pittsburgh Steelers","Home",24,20,4,70305
"166",2019,3,"Cleveland Browns","Los Angeles Rams","Away",13,20,-7,67431
"167",2019,3,"Washington Redskins","Chicago Bears","Away",15,31,-16,65488
"168",2019,4,"Green Bay Packers","Philadelphia Eagles","Away",27,34,-7,77845
"169",2019,4,"Houston Texans","Carolina Panthers","Away",10,16,-6,71793
"170",2019,4,"New York Giants","Washington Redskins","Home",24,3,21,74664
"171",2019,4,"Indianapolis Colts","Oakland Raiders","Away",24,31,-7,61110
"172",2019,4,"Buffalo Bills","New England Patriots","Away",10,16,-6,68839
"173",2019,4,"Miami Dolphins","Los Angeles Chargers","Away",10,30,-20,63067
"174",2019,4,"Baltimore Ravens","Cleveland Browns","Away",25,40,-15,70627
"175",2019,4,"Detroit Lions","Kansas City Chiefs","Away",30,34,-4,61342
"176",2019,4,"Atlanta Falcons","Tennessee Titans","Away",10,24,-14,71601
"177",2019,4,"Arizona Cardinals","Seattle Seahawks","Away",10,27,-17,61323
"178",2019,4,"Los Angeles Rams","Tampa Bay Buccaneers","Away",40,55,-15,71229
"179",2019,4,"Chicago Bears","Minnesota Vikings","Home",16,6,10,61916
"180",2019,4,"Denver Broncos","Jacksonville Jaguars","Away",24,26,-2,75937
"181",2019,4,"New Orleans Saints","Dallas Cowboys","Home",12,10,2,73082
"182",2019,4,"Pittsburgh Steelers","Cincinnati Bengals","Home",27,3,24,62237
"183",2019,5,"Seattle Seahawks","Los Angeles Rams","Home",30,29,1,68990
"184",2019,5,"Philadelphia Eagles","New York Jets","Home",31,6,25,69783
"185",2019,5,"New York Giants","Minnesota Vikings","Away",10,28,-18,74664
"186",2019,5,"Houston Texans","Atlanta Falcons","Home",53,32,21,71793
"187",2019,5,"Washington Redskins","New England Patriots","Away",7,33,-26,65488
"188",2019,5,"Oakland Raiders","Chicago Bears","Home",24,21,3,52549
"189",2019,5,"Carolina Panthers","Jacksonville Jaguars","Home",34,27,7,72220
"190",2019,5,"New Orleans Saints","Tampa Bay Buccaneers","Home",31,24,7,73082
"191",2019,5,"Cincinnati Bengals","Arizona Cardinals","Away",23,26,-3,47179
"192",2019,5,"Tennessee Titans","Buffalo Bills","Away",7,14,-7,64509
"193",2019,5,"Pittsburgh Steelers","Baltimore Ravens","Away",23,26,-3,62237
"194",2019,5,"Los Angeles Chargers","Denver Broncos","Away",13,20,-7,31750
"195",2019,5,"Dallas Cowboys","Green Bay Packers","Away",24,34,-10,90929
"196",2019,5,"Kansas City Chiefs","Indianapolis Colts","Away",13,19,-6,73465
"197",2019,5,"San Francisco 49ers","Cleveland Browns","Home",31,3,28,70305
"198",2019,6,"New England Patriots","New York Giants","Home",35,14,21,65753
"199",2019,6,"Tampa Bay Buccaneers","Carolina Panthers","Away",26,37,-11,51898
"200",2019,6,"Miami Dolphins","Washington Redskins","Away",16,17,-1,63067
"201",2019,6,"Minnesota Vikings","Philadelphia Eagles","Home",38,20,18,66849
"202",2019,6,"Kansas City Chiefs","Houston Texans","Away",24,31,-7,73465
"203",2019,6,"Cleveland Browns","Seattle Seahawks","Away",28,32,-4,67431
"204",2019,6,"Jacksonville Jaguars","New Orleans Saints","Away",6,13,-7,63085
"205",2019,6,"Baltimore Ravens","Cincinnati Bengals","Home",23,17,6,70627
"206",2019,6,"Los Angeles Rams","San Francisco 49ers","Away",7,20,-13,71229
"207",2019,6,"Arizona Cardinals","Atlanta Falcons","Home",34,33,1,61323
"208",2019,6,"Denver Broncos","Tennessee Titans","Home",16,0,16,75937
"209",2019,6,"New York Jets","Dallas Cowboys","Home",24,22,2,78523
"210",2019,6,"Los Angeles Chargers","Pittsburgh Steelers","Away",17,24,-7,31750
"211",2019,6,"Green Bay Packers","Detroit Lions","Home",23,22,1,77845
"212",2019,7,"Denver Broncos","Kansas City Chiefs","Away",6,30,-24,75937
"213",2019,7,"Buffalo Bills","Miami Dolphins","Home",31,21,10,68839
"214",2019,7,"Detroit Lions","Minnesota Vikings","Away",30,42,-12,61342
"215",2019,7,"Indianapolis Colts","Houston Texans","Home",30,23,7,61110
"216",2019,7,"Washington Redskins","San Francisco 49ers","Away",0,9,-9,65488
"217",2019,7,"Green Bay Packers","Oakland Raiders","Home",42,24,18,77845
"218",2019,7,"Cincinnati Bengals","Jacksonville Jaguars","Away",17,27,-10,47179
"219",2019,7,"New York Giants","Arizona Cardinals","Away",21,27,-6,74664
"220",2019,7,"Atlanta Falcons","Los Angeles Rams","Away",10,37,-27,71601
"221",2019,7,"Tennessee Titans","Los Angeles Chargers","Home",23,20,3,64509
"222",2019,7,"Chicago Bears","New Orleans Saints","Away",25,36,-11,61916
"223",2019,7,"Seattle Seahawks","Baltimore Ravens","Away",16,30,-14,68990
"224",2019,7,"Dallas Cowboys","Philadelphia Eagles","Home",37,10,27,90929
"225",2019,7,"New York Jets","New England Patriots","Away",0,33,-33,78523
"226",2019,8,"Minnesota Vikings","Washington Redskins","Home",19,9,10,66849
"227",2019,8,"Chicago Bears","Los Angeles Chargers","Away",16,17,-1,61916
"228",2019,8,"Indianapolis Colts","Denver Broncos","Home",15,13,2,61110
"229",2019,8,"Buffalo Bills","Philadelphia Eagles","Away",13,31,-18,68839
"230",2019,8,"Detroit Lions","New York Giants","Home",31,26,5,61342
"231",2019,8,"Atlanta Falcons","Seattle Seahawks","Away",20,27,-7,71601
"232",2019,8,"Tennessee Titans","Tampa Bay Buccaneers","Home",27,23,4,64509
"233",2019,8,"Los Angeles Rams","Cincinnati Bengals","Home",24,10,14,71229
"234",2019,8,"Jacksonville Jaguars","New York Jets","Home",29,15,14,63085
"235",2019,8,"New Orleans Saints","Arizona Cardinals","Home",31,9,22,73082
"236",2019,8,"San Francisco 49ers","Carolina Panthers","Home",51,13,38,70305
"237",2019,8,"New England Patriots","Cleveland Browns","Home",27,13,14,65753
"238",2019,8,"Houston Texans","Oakland Raiders","Home",27,24,3,71793
"239",2019,8,"Kansas City Chiefs","Green Bay Packers","Away",24,31,-7,73465
"240",2019,8,"Pittsburgh Steelers","Miami Dolphins","Home",27,14,13,62237
"241",2019,9,"Arizona Cardinals","San Francisco 49ers","Away",25,28,-3,61323
"242",2019,9,"Jacksonville Jaguars","Houston Texans","Away",3,26,-23,63085
"243",2019,9,"Philadelphia Eagles","Chicago Bears","Home",22,14,8,69783
"244",2019,9,"Carolina Panthers","Tennessee Titans","Home",30,20,10,72220
"245",2019,9,"Miami Dolphins","New York Jets","Home",26,18,8,63067
"246",2019,9,"Pittsburgh Steelers","Indianapolis Colts","Home",26,24,2,62237
"247",2019,9,"Buffalo Bills","Washington Redskins","Home",24,9,15,68839
"248",2019,9,"Kansas City Chiefs","Minnesota Vikings","Home",26,23,3,73465
"249",2019,9,"Oakland Raiders","Detroit Lions","Home",31,24,7,52549
"250",2019,9,"Seattle Seahawks","Tampa Bay Buccaneers","Home",40,34,6,68990
"251",2019,9,"Denver Broncos","Cleveland Browns","Home",24,19,5,75937
"252",2019,9,"Los Angeles Chargers","Green Bay Packers","Home",26,11,15,31750
"253",2019,9,"Baltimore Ravens","New England Patriots","Home",37,20,17,70627
"254",2019,9,"New York Giants","Dallas Cowboys","Away",18,37,-19,74664
"255",2019,10,"Oakland Raiders","Los Angeles Chargers","Home",26,24,2,52549
"256",2019,10,"New Orleans Saints","Atlanta Falcons","Away",9,26,-17,73082
"257",2019,10,"Chicago Bears","Detroit Lions","Home",20,13,7,61916
"258",2019,10,"Cincinnati Bengals","Baltimore Ravens","Away",13,49,-36,47179
"259",2019,10,"Cleveland Browns","Buffalo Bills","Home",19,16,3,67431
"260",2019,10,"Tennessee Titans","Kansas City Chiefs","Home",35,32,3,64509
"261",2019,10,"Tampa Bay Buccaneers","Arizona Cardinals","Home",30,27,3,51898
"262",2019,10,"New York Jets","New York Giants","Home",34,27,7,78523
"263",2019,10,"Indianapolis Colts","Miami Dolphins","Away",12,16,-4,61110
"264",2019,10,"Pittsburgh Steelers","Los Angeles Rams","Home",17,12,5,62237
"265",2019,10,"Green Bay Packers","Carolina Panthers","Home",24,16,8,77845
"266",2019,10,"Dallas Cowboys","Minnesota Vikings","Away",24,28,-4,90929
"267",2019,10,"San Francisco 49ers","Seattle Seahawks","Away",24,27,-3,70305
"268",2019,11,"Cleveland Browns","Pittsburgh Steelers","Home",21,7,14,67431
"269",2019,11,"Miami Dolphins","Buffalo Bills","Away",20,37,-17,63067
"270",2019,11,"Baltimore Ravens","Houston Texans","Home",41,7,34,70627
"271",2019,11,"Detroit Lions","Dallas Cowboys","Away",27,35,-8,61342
"272",2019,11,"Carolina Panthers","Atlanta Falcons","Away",3,29,-26,72220
"273",2019,11,"Minnesota Vikings","Denver Broncos","Home",27,23,4,66849
"274",2019,11,"Tampa Bay Buccaneers","New Orleans Saints","Away",17,34,-17,51898
"275",2019,11,"Washington Redskins","New York Jets","Away",17,34,-17,65488
"276",2019,11,"Indianapolis Colts","Jacksonville Jaguars","Home",33,13,20,61110
"277",2019,11,"San Francisco 49ers","Arizona Cardinals","Home",36,26,10,70305
"278",2019,11,"Oakland Raiders","Cincinnati Bengals","Home",17,10,7,52549
"279",2019,11,"Philadelphia Eagles","New England Patriots","Away",10,17,-7,69783
"280",2019,11,"Los Angeles Rams","Chicago Bears","Home",17,7,10,71229
"281",2019,11,"Los Angeles Chargers","Kansas City Chiefs","Away",17,24,-7,31750
"282",2019,12,"Houston Texans","Indianapolis Colts","Home",20,17,3,71793
"283",2019,12,"Chicago Bears","New York Giants","Home",19,14,5,61916
"284",2019,12,"New York Jets","Oakland Raiders","Home",34,3,31,78523
"285",2019,12,"Washington Redskins","Detroit Lions","Home",19,16,3,65488
"286",2019,12,"Cincinnati Bengals","Pittsburgh Steelers","Away",10,16,-6,47179
"287",2019,12,"Buffalo Bills","Denver Broncos","Home",20,3,17,68839
"288",2019,12,"Philadelphia Eagles","Seattle Seahawks","Away",9,17,-8,69783
"289",2019,12,"Cleveland Browns","Miami Dolphins","Home",41,24,17,67431
"290",2019,12,"Atlanta Falcons","Tampa Bay Buccaneers","Away",22,35,-13,71601
"291",2019,12,"New Orleans Saints","Carolina Panthers","Home",34,31,3,73082
"292",2019,12,"Tennessee Titans","Jacksonville Jaguars","Home",42,20,22,64509
"293",2019,12,"New England Patriots","Dallas Cowboys","Home",13,9,4,65753
"294",2019,12,"San Francisco 49ers","Green Bay Packers","Home",37,8,29,70305
"295",2019,12,"Los Angeles Rams","Baltimore Ravens","Away",6,45,-39,71229
"296",2019,13,"Detroit Lions","Chicago Bears","Away",20,24,-4,61342
"297",2019,13,"Dallas Cowboys","Buffalo Bills","Away",15,26,-11,90929
"298",2019,13,"Atlanta Falcons","New Orleans Saints","Away",18,26,-8,71601
"299",2019,13,"New York Giants","Green Bay Packers","Away",13,31,-18,74664
"300",2019,13,"Carolina Panthers","Washington Redskins","Away",21,29,-8,72220
"301",2019,13,"Jacksonville Jaguars","Tampa Bay Buccaneers","Away",11,28,-17,63085
"302",2019,13,"Indianapolis Colts","Tennessee Titans","Away",17,31,-14,61110
"303",2019,13,"Baltimore Ravens","San Francisco 49ers","Home",20,17,3,70627
"304",2019,13,"Miami Dolphins","Philadelphia Eagles","Home",37,31,6,63067
"305",2019,13,"Cincinnati Bengals","New York Jets","Home",22,6,16,47179
"306",2019,13,"Pittsburgh Steelers","Cleveland Browns","Home",20,13,7,62237
"307",2019,13,"Arizona Cardinals","Los Angeles Rams","Away",7,34,-27,61323
"308",2019,13,"Kansas City Chiefs","Oakland Raiders","Home",40,9,31,73465
"309",2019,13,"Denver Broncos","Los Angeles Chargers","Home",23,20,3,75937
"310",2019,13,"Houston Texans","New England Patriots","Home",28,22,6,71793
"311",2019,13,"Seattle Seahawks","Minnesota Vikings","Home",37,30,7,68990
"312",2019,14,"Chicago Bears","Dallas Cowboys","Home",31,24,7,61916
"313",2019,14,"Buffalo Bills","Baltimore Ravens","Away",17,24,-7,68839
"314",2019,14,"New Orleans Saints","San Francisco 49ers","Away",46,48,-2,73082
"315",2019,14,"Houston Texans","Denver Broncos","Away",24,38,-14,71793
"316",2019,14,"Green Bay Packers","Washington Redskins","Home",20,15,5,77845
"317",2019,14,"Atlanta Falcons","Carolina Panthers","Home",40,20,20,71601
"318",2019,14,"Minnesota Vikings","Detroit Lions","Home",20,7,13,66849
"319",2019,14,"Tampa Bay Buccaneers","Indianapolis Colts","Home",38,35,3,51898
"320",2019,14,"New York Jets","Miami Dolphins","Home",22,21,1,78523
"321",2019,14,"Cleveland Browns","Cincinnati Bengals","Home",27,19,8,67431
"322",2019,14,"Jacksonville Jaguars","Los Angeles Chargers","Away",10,45,-35,63085
"323",2019,14,"Arizona Cardinals","Pittsburgh Steelers","Away",17,23,-6,61323
"324",2019,14,"Oakland Raiders","Tennessee Titans","Away",21,42,-21,52549
"325",2019,14,"New England Patriots","Kansas City Chiefs","Away",16,23,-7,65753
"326",2019,14,"Los Angeles Rams","Seattle Seahawks","Home",28,12,16,71229
"327",2019,14,"Philadelphia Eagles","New York Giants","Home",23,17,6,69783
"328",2019,15,"Baltimore Ravens","New York Jets","Home",42,21,21,70627
"329",2019,15,"Green Bay Packers","Chicago Bears","Home",21,13,8,77845
"330",2019,15,"New York Giants","Miami Dolphins","Home",36,20,16,74664
"331",2019,15,"Cincinnati Bengals","New England Patriots","Away",13,34,-21,47179
"332",2019,15,"Carolina Panthers","Seattle Seahawks","Away",24,30,-6,72220
"333",2019,15,"Kansas City Chiefs","Denver Broncos","Home",23,3,20,73465
"334",2019,15,"Washington Redskins","Philadelphia Eagles","Away",27,37,-10,65488
"335",2019,15,"Tennessee Titans","Houston Texans","Away",21,24,-3,64509
"336",2019,15,"Detroit Lions","Tampa Bay Buccaneers","Away",17,38,-21,61342
"337",2019,15,"Arizona Cardinals","Cleveland Browns","Home",38,24,14,61323
"338",2019,15,"Los Angeles Chargers","Minnesota Vikings","Away",10,39,-29,31750
"339",2019,15,"Oakland Raiders","Jacksonville Jaguars","Away",16,20,-4,52549
"340",2019,15,"Dallas Cowboys","Los Angeles Rams","Home",44,21,23,90929
"341",2019,15,"San Francisco 49ers","Atlanta Falcons","Away",22,29,-7,70305
"342",2019,15,"Pittsburgh Steelers","Buffalo Bills","Away",10,17,-7,62237
"343",2019,15,"New Orleans Saints","Indianapolis Colts","Home",34,7,27,73082
"344",2019,16,"Tampa Bay Buccaneers","Houston Texans","Away",20,23,-3,51898
"345",2019,16,"New England Patriots","Buffalo Bills","Home",24,17,7,65753
"346",2019,16,"San Francisco 49ers","Los Angeles Rams","Home",34,31,3,70305
"347",2019,16,"Atlanta Falcons","Jacksonville Jaguars","Home",24,12,12,71601
"348",2019,16,"Washington Redskins","New York Giants","Away",35,41,-6,65488
"349",2019,16,"Cleveland Browns","Baltimore Ravens","Away",15,31,-16,67431
"350",2019,16,"Tennessee Titans","New Orleans Saints","Away",28,38,-10,64509
"351",2019,16,"Miami Dolphins","Cincinnati Bengals","Home",38,35,3,63067
"352",2019,16,"New York Jets","Pittsburgh Steelers","Home",16,10,6,78523
"353",2019,16,"Indianapolis Colts","Carolina Panthers","Home",38,6,32,61110
"354",2019,16,"Los Angeles Chargers","Oakland Raiders","Away",17,24,-7,31750
"355",2019,16,"Denver Broncos","Detroit Lions","Home",27,17,10,75937
"356",2019,16,"Philadelphia Eagles","Dallas Cowboys","Home",17,9,8,69783
"357",2019,16,"Seattle Seahawks","Arizona Cardinals","Away",13,27,-14,68990
"358",2019,16,"Chicago Bears","Kansas City Chiefs","Away",3,26,-23,61916
"359",2019,16,"Minnesota Vikings","Green Bay Packers","Away",10,23,-13,66849
"360",2019,17,"Carolina Panthers","New Orleans Saints","Away",10,42,-32,72220
"361",2019,17,"Kansas City Chiefs","Los Angeles Chargers","Home",31,21,10,73465
"362",2019,17,"Detroit Lions","Green Bay Packers","Away",20,23,-3,61342
"363",2019,17,"Tampa Bay Buccaneers","Atlanta Falcons","Away",22,28,-6,51898
"364",2019,17,"New England Patriots","Miami Dolphins","Away",24,27,-3,65753
"365",2019,17,"Minnesota Vikings","Chicago Bears","Away",19,21,-2,66849
"366",2019,17,"Cincinnati Bengals","Cleveland Browns","Home",33,23,10,47179
"367",2019,17,"Buffalo Bills","New York Jets","Away",6,13,-7,68839
"368",2019,17,"Denver Broncos","Oakland Raiders","Home",16,15,1,75937
"369",2019,17,"Houston Texans","Tennessee Titans","Away",14,35,-21,71793
"370",2019,17,"Jacksonville Jaguars","Indianapolis Colts","Home",38,20,18,63085
"371",2019,17,"New York Giants","Philadelphia Eagles","Away",17,34,-17,74664
"372",2019,17,"Dallas Cowboys","Washington Redskins","Home",47,16,31,90929
"373",2019,17,"Baltimore Ravens","Pittsburgh Steelers","Home",28,10,18,70627
"374",2019,17,"Los Angeles Rams","Arizona Cardinals","Home",31,24,7,71229
"375",2019,17,"Seattle Seahawks","San Francisco 49ers","Away",21,26,-5,68990
"376",2019,NA,NA,NA,NA,NA,NA,NA,NA
"377",2019,NA,"Houston Texans","Buffalo Bills","Home",22,19,3,71793
"378",2019,NA,"New England Patriots","Tennessee Titans","Away",13,20,-7,65753
"379",2019,NA,"New Orleans Saints","Minnesota Vikings","Away",20,26,-6,73082
"380",2019,NA,"Philadelphia Eagles","Seattle Seahawks","Away",9,17,-8,69783
"381",2019,NA,"San Francisco 49ers","Minnesota Vikings","Home",27,10,17,70305
"382",2019,NA,"Baltimore Ravens","Tennessee Titans","Away",12,28,-16,70627
"383",2019,NA,"Kansas City Chiefs","Houston Texans","Home",51,31,20,73465
"384",2019,NA,"Green Bay Packers","Seattle Seahawks","Home",28,23,5,77845
"385",2019,NA,"Kansas City Chiefs","Tennessee Titans","Home",35,24,11,73465
"386",2019,NA,"San Francisco 49ers","Green Bay Packers","Home",37,20,17,70305
"387",2019,NA,"San Francisco 49ers","Kansas City Chiefs","Away",20,31,-11,70305
"388",2018,1,"Philadelphia Eagles","Atlanta Falcons","Home",18,12,6,69696
"389",2018,1,"New Orleans Saints","Tampa Bay Buccaneers","Away",40,48,-8,73051
"390",2018,1,"Minnesota Vikings","San Francisco 49ers","Home",24,16,8,66811
"391",2018,1,"Miami Dolphins","Tennessee Titans","Home",27,20,7,65560
"392",2018,1,"New York Giants","Jacksonville Jaguars","Away",15,20,-5,76940
"393",2018,1,"Cleveland Browns","Pittsburgh Steelers","Away",21,21,0,65765
"394",2018,1,"New England Patriots","Houston Texans","Home",27,20,7,65878
"395",2018,1,"Indianapolis Colts","Cincinnati Bengals","Away",23,34,-11,59199
"396",2018,1,"Baltimore Ravens","Buffalo Bills","Home",47,3,44,70431
"397",2018,1,"Los Angeles Chargers","Kansas City Chiefs","Away",28,38,-10,32768
"398",2018,1,"Carolina Panthers","Dallas Cowboys","Home",16,8,8,73772
"399",2018,1,"Arizona Cardinals","Washington Redskins","Away",6,24,-18,62013
"400",2018,1,"Denver Broncos","Seattle Seahawks","Home",27,24,3,76446
"401",2018,1,"Green Bay Packers","Chicago Bears","Home",24,23,1,77834
"402",2018,1,"Detroit Lions","New York Jets","Away",17,48,-31,62795
"403",2018,1,"Oakland Raiders","Los Angeles Rams","Away",13,33,-20,57919
"404",2018,2,"Cincinnati Bengals","Baltimore Ravens","Home",34,23,11,50753
"405",2018,2,"Green Bay Packers","Minnesota Vikings","Away",29,29,0,77834
"406",2018,2,"Tampa Bay Buccaneers","Philadelphia Eagles","Home",27,21,6,54356
"407",2018,2,"Atlanta Falcons","Carolina Panthers","Home",31,24,7,72898
"408",2018,2,"Pittsburgh Steelers","Kansas City Chiefs","Away",37,42,-5,63456
"409",2018,2,"New York Jets","Miami Dolphins","Away",12,20,-8,77982
"410",2018,2,"New Orleans Saints","Cleveland Browns","Home",21,18,3,73051
"411",2018,2,"Tennessee Titans","Houston Texans","Home",20,17,3,64520
"412",2018,2,"Washington Redskins","Indianapolis Colts","Away",9,21,-12,61028
"413",2018,2,"Buffalo Bills","Los Angeles Chargers","Away",20,31,-11,64961
"414",2018,2,"San Francisco 49ers","Detroit Lions","Home",30,27,3,69148
"415",2018,2,"Los Angeles Rams","Arizona Cardinals","Home",34,0,34,72429
"416",2018,2,"Jacksonville Jaguars","New England Patriots","Home",31,20,11,66674
"417",2018,2,"Denver Broncos","Oakland Raiders","Home",20,19,1,76446
"418",2018,2,"Dallas Cowboys","New York Giants","Home",20,13,7,91619
"419",2018,2,"Chicago Bears","Seattle Seahawks","Home",24,17,7,61815
"420",2018,3,"Cleveland Browns","New York Jets","Home",21,17,4,65765
"421",2018,3,"Houston Texans","New York Giants","Away",22,27,-5,71804
"422",2018,3,"Baltimore Ravens","Denver Broncos","Home",27,14,13,70431
"423",2018,3,"Philadelphia Eagles","Indianapolis Colts","Home",20,16,4,69696
"424",2018,3,"Minnesota Vikings","Buffalo Bills","Away",6,27,-21,66811
"425",2018,3,"Washington Redskins","Green Bay Packers","Home",31,17,14,61028
"426",2018,3,"Carolina Panthers","Cincinnati Bengals","Home",31,21,10,73772
"427",2018,3,"Atlanta Falcons","New Orleans Saints","Away",37,43,-6,72898
"428",2018,3,"Kansas City Chiefs","San Francisco 49ers","Home",38,27,11,75972
"429",2018,3,"Miami Dolphins","Oakland Raiders","Home",28,20,8,65560
"430",2018,3,"Jacksonville Jaguars","Tennessee Titans","Away",6,9,-3,66674
"431",2018,3,"Los Angeles Rams","Los Angeles Chargers","Home",35,23,12,72429
"432",2018,3,"Seattle Seahawks","Dallas Cowboys","Home",24,13,11,69001
"433",2018,3,"Arizona Cardinals","Chicago Bears","Away",14,16,-2,62013
"434",2018,3,"Detroit Lions","New England Patriots","Home",26,10,16,62795
"435",2018,3,"Tampa Bay Buccaneers","Pittsburgh Steelers","Away",27,30,-3,54356
"436",2018,4,"Los Angeles Rams","Minnesota Vikings","Home",38,31,7,72429
"437",2018,4,"New England Patriots","Miami Dolphins","Home",38,7,31,65878
"438",2018,4,"Jacksonville Jaguars","New York Jets","Home",31,12,19,66674
"439",2018,4,"Indianapolis Colts","Houston Texans","Away",34,37,-3,59199
"440",2018,4,"Green Bay Packers","Buffalo Bills","Home",22,0,22,77834
"441",2018,4,"Dallas Cowboys","Detroit Lions","Home",26,24,2,91619
"442",2018,4,"Chicago Bears","Tampa Bay Buccaneers","Home",48,10,38,61815
"443",2018,4,"Tennessee Titans","Philadelphia Eagles","Home",26,23,3,64520
"444",2018,4,"Atlanta Falcons","Cincinnati Bengals","Away",36,37,-1,72898
"445",2018,4,"Oakland Raiders","Cleveland Browns","Home",45,42,3,57919
"446",2018,4,"Arizona Cardinals","Seattle Seahawks","Away",17,20,-3,62013
"447",2018,4,"New York Giants","New Orleans Saints","Away",18,33,-15,76940
"448",2018,4,"Los Angeles Chargers","San Francisco 49ers","Home",29,27,2,32768
"449",2018,4,"Pittsburgh Steelers","Baltimore Ravens","Away",14,26,-12,63456
"450",2018,4,"Denver Broncos","Kansas City Chiefs","Away",23,27,-4,76446
"451",2018,5,"New England Patriots","Indianapolis Colts","Home",38,24,14,65878
"452",2018,5,"Carolina Panthers","New York Giants","Home",33,31,2,73772
"453",2018,5,"Detroit Lions","Green Bay Packers","Home",31,23,8,62795
"454",2018,5,"Cincinnati Bengals","Miami Dolphins","Home",27,17,10,50753
"455",2018,5,"Pittsburgh Steelers","Atlanta Falcons","Home",41,17,24,63456
"456",2018,5,"Kansas City Chiefs","Jacksonville Jaguars","Home",30,14,16,75972
"457",2018,5,"Cleveland Browns","Baltimore Ravens","Home",12,9,3,65765
"458",2018,5,"New York Jets","Denver Broncos","Home",34,16,18,77982
"459",2018,5,"Buffalo Bills","Tennessee Titans","Home",13,12,1,64961
"460",2018,5,"Los Angeles Chargers","Oakland Raiders","Home",26,10,16,32768
"461",2018,5,"San Francisco 49ers","Arizona Cardinals","Away",18,28,-10,69148
"462",2018,5,"Seattle Seahawks","Los Angeles Rams","Away",31,33,-2,69001
"463",2018,5,"Philadelphia Eagles","Minnesota Vikings","Away",21,23,-2,69696
"464",2018,5,"Houston Texans","Dallas Cowboys","Home",19,16,3,71804
"465",2018,5,"New Orleans Saints","Washington Redskins","Home",43,19,24,73051
"466",2018,6,"New York Giants","Philadelphia Eagles","Away",13,34,-21,76940
"467",2018,6,"Miami Dolphins","Chicago Bears","Home",31,28,3,65560
"468",2018,6,"Washington Redskins","Carolina Panthers","Home",23,17,6,61028
"469",2018,6,"New York Jets","Indianapolis Colts","Home",42,34,8,77982
"470",2018,6,"Houston Texans","Buffalo Bills","Home",20,13,7,71804
"471",2018,6,"Oakland Raiders","Seattle Seahawks","Away",3,27,-24,57919
"472",2018,6,"Cincinnati Bengals","Pittsburgh Steelers","Away",21,28,-7,50753
"473",2018,6,"Minnesota Vikings","Arizona Cardinals","Home",27,17,10,66811
"474",2018,6,"Atlanta Falcons","Tampa Bay Buccaneers","Home",34,29,5,72898
"475",2018,6,"Cleveland Browns","Los Angeles Chargers","Away",14,38,-24,65765
"476",2018,6,"Denver Broncos","Los Angeles Rams","Away",20,23,-3,76446
"477",2018,6,"Tennessee Titans","Baltimore Ravens","Away",0,21,-21,64520
"478",2018,6,"Dallas Cowboys","Jacksonville Jaguars","Home",40,7,33,91619
"479",2018,6,"New England Patriots","Kansas City Chiefs","Home",43,40,3,65878
"480",2018,6,"Green Bay Packers","San Francisco 49ers","Home",33,30,3,77834
"481",2018,7,"Arizona Cardinals","Denver Broncos","Away",10,45,-35,62013
"482",2018,7,"Los Angeles Chargers","Tennessee Titans","Home",20,19,1,32768
"483",2018,7,"Philadelphia Eagles","Carolina Panthers","Away",17,21,-4,69696
"484",2018,7,"Miami Dolphins","Detroit Lions","Away",21,32,-11,65560
"485",2018,7,"Chicago Bears","New England Patriots","Away",31,38,-7,61815
"486",2018,7,"New York Jets","Minnesota Vikings","Away",17,37,-20,77982
"487",2018,7,"Tampa Bay Buccaneers","Cleveland Browns","Home",26,23,3,54356
"488",2018,7,"Indianapolis Colts","Buffalo Bills","Home",37,5,32,59199
"489",2018,7,"Jacksonville Jaguars","Houston Texans","Away",7,20,-13,66674
"490",2018,7,"Baltimore Ravens","New Orleans Saints","Away",23,24,-1,70431
"491",2018,7,"Washington Redskins","Dallas Cowboys","Home",20,17,3,61028
"492",2018,7,"San Francisco 49ers","Los Angeles Rams","Away",10,39,-29,69148
"493",2018,7,"Kansas City Chiefs","Cincinnati Bengals","Home",45,10,35,75972
"494",2018,7,"Atlanta Falcons","New York Giants","Home",23,20,3,72898
"495",2018,8,"Houston Texans","Miami Dolphins","Home",42,23,19,71804
"496",2018,8,"Jacksonville Jaguars","Philadelphia Eagles","Away",18,24,-6,66674
"497",2018,8,"Carolina Panthers","Baltimore Ravens","Home",36,21,15,73772
"498",2018,8,"Detroit Lions","Seattle Seahawks","Away",14,28,-14,62795
"499",2018,8,"Chicago Bears","New York Jets","Home",24,10,14,61815
"500",2018,8,"Kansas City Chiefs","Denver Broncos","Home",30,23,7,75972
"501",2018,8,"Pittsburgh Steelers","Cleveland Browns","Home",33,18,15,63456
"502",2018,8,"Cincinnati Bengals","Tampa Bay Buccaneers","Home",37,34,3,50753
"503",2018,8,"New York Giants","Washington Redskins","Away",13,20,-7,76940
"504",2018,8,"Oakland Raiders","Indianapolis Colts","Away",28,42,-14,57919
"505",2018,8,"Los Angeles Rams","Green Bay Packers","Home",29,27,2,72429
"506",2018,8,"Arizona Cardinals","San Francisco 49ers","Home",18,15,3,62013
"507",2018,8,"Minnesota Vikings","New Orleans Saints","Away",20,30,-10,66811
"508",2018,8,"Buffalo Bills","New England Patriots","Away",6,25,-19,64961
"509",2018,9,"San Francisco 49ers","Oakland Raiders","Home",34,3,31,69148
"510",2018,9,"Washington Redskins","Atlanta Falcons","Away",14,38,-24,61028
"511",2018,9,"Baltimore Ravens","Pittsburgh Steelers","Away",16,23,-7,70431
"512",2018,9,"Carolina Panthers","Tampa Bay Buccaneers","Home",42,28,14,73772
"513",2018,9,"Minnesota Vikings","Detroit Lions","Home",24,9,15,66811
"514",2018,9,"Miami Dolphins","New York Jets","Home",13,6,7,65560
"515",2018,9,"Cleveland Browns","Kansas City Chiefs","Away",21,37,-16,65765
"516",2018,9,"Buffalo Bills","Chicago Bears","Away",9,41,-32,64961
"517",2018,9,"Seattle Seahawks","Los Angeles Chargers","Away",17,25,-8,69001
"518",2018,9,"Denver Broncos","Houston Texans","Away",17,19,-2,76446
"519",2018,9,"New Orleans Saints","Los Angeles Rams","Home",45,35,10,73051
"520",2018,9,"New England Patriots","Green Bay Packers","Home",31,17,14,65878
"521",2018,9,"Dallas Cowboys","Tennessee Titans","Away",14,28,-14,91619
"522",2018,10,"Pittsburgh Steelers","Carolina Panthers","Home",52,21,31,63456
"523",2018,10,"Chicago Bears","Detroit Lions","Home",34,22,12,61815
"524",2018,10,"Cincinnati Bengals","New Orleans Saints","Away",14,51,-37,50753
"525",2018,10,"Kansas City Chiefs","Arizona Cardinals","Home",26,14,12,75972
"526",2018,10,"Cleveland Browns","Atlanta Falcons","Home",28,16,12,65765
"527",2018,10,"Indianapolis Colts","Jacksonville Jaguars","Home",29,26,3,59199
"528",2018,10,"Tampa Bay Buccaneers","Washington Redskins","Away",3,16,-13,54356
"529",2018,10,"Tennessee Titans","New England Patriots","Home",34,10,24,64520
"530",2018,10,"New York Jets","Buffalo Bills","Away",10,41,-31,77982
"531",2018,10,"Oakland Raiders","Los Angeles Chargers","Away",6,20,-14,57919
"532",2018,10,"Green Bay Packers","Miami Dolphins","Home",31,12,19,77834
"533",2018,10,"Los Angeles Rams","Seattle Seahawks","Home",36,31,5,72429
"534",2018,10,"Philadelphia Eagles","Dallas Cowboys","Away",20,27,-7,69696
"535",2018,10,"San Francisco 49ers","New York Giants","Away",23,27,-4,69148
"536",2018,11,"Seattle Seahawks","Green Bay Packers","Home",27,24,3,69001
"537",2018,11,"Jacksonville Jaguars","Pittsburgh Steelers","Away",16,20,-4,66674
"538",2018,11,"Detroit Lions","Carolina Panthers","Home",20,19,1,62795
"539",2018,11,"Baltimore Ravens","Cincinnati Bengals","Home",24,21,3,70431
"540",2018,11,"New York Giants","Tampa Bay Buccaneers","Home",38,35,3,76940
"541",2018,11,"Atlanta Falcons","Dallas Cowboys","Away",19,22,-3,72898
"542",2018,11,"Indianapolis Colts","Tennessee Titans","Home",38,10,28,59199
"543",2018,11,"Washington Redskins","Houston Texans","Away",21,23,-2,61028
"544",2018,11,"Arizona Cardinals","Oakland Raiders","Away",21,23,-2,62013
"545",2018,11,"Los Angeles Chargers","Denver Broncos","Away",22,23,-1,32768
"546",2018,11,"New Orleans Saints","Philadelphia Eagles","Home",48,7,41,73051
"547",2018,11,"Chicago Bears","Minnesota Vikings","Home",25,20,5,61815
"548",2018,11,"Los Angeles Rams","Kansas City Chiefs","Home",54,51,3,72429
"549",2018,12,"Detroit Lions","Chicago Bears","Away",16,23,-7,62795
"550",2018,12,"Dallas Cowboys","Washington Redskins","Home",31,23,8,91619
"551",2018,12,"New Orleans Saints","Atlanta Falcons","Home",31,17,14,73051
"552",2018,12,"Baltimore Ravens","Oakland Raiders","Home",34,17,17,70431
"553",2018,12,"New York Jets","New England Patriots","Away",13,27,-14,77982
"554",2018,12,"Buffalo Bills","Jacksonville Jaguars","Home",24,21,3,64961
"555",2018,12,"Tampa Bay Buccaneers","San Francisco 49ers","Home",27,9,18,54356
"556",2018,12,"Carolina Panthers","Seattle Seahawks","Away",27,30,-3,73772
"557",2018,12,"Cincinnati Bengals","Cleveland Browns","Away",20,35,-15,50753
"558",2018,12,"Philadelphia Eagles","New York Giants","Home",25,22,3,69696
"559",2018,12,"Los Angeles Chargers","Arizona Cardinals","Home",45,10,35,32768
"560",2018,12,"Denver Broncos","Pittsburgh Steelers","Home",24,17,7,76446
"561",2018,12,"Indianapolis Colts","Miami Dolphins","Home",27,24,3,59199
"562",2018,12,"Minnesota Vikings","Green Bay Packers","Home",24,17,7,66811
"563",2018,12,"Houston Texans","Tennessee Titans","Home",34,17,17,71804
"564",2018,13,"Dallas Cowboys","New Orleans Saints","Home",13,10,3,91619
"565",2018,13,"Houston Texans","Cleveland Browns","Home",29,13,16,71804
"566",2018,13,"Cincinnati Bengals","Denver Broncos","Away",10,24,-14,50753
"567",2018,13,"Detroit Lions","Los Angeles Rams","Away",16,30,-14,62795
"568",2018,13,"Green Bay Packers","Arizona Cardinals","Away",17,20,-3,77834
"569",2018,13,"Atlanta Falcons","Baltimore Ravens","Away",16,26,-10,72898
"570",2018,13,"Jacksonville Jaguars","Indianapolis Colts","Home",6,0,6,66674
"571",2018,13,"Miami Dolphins","Buffalo Bills","Home",21,17,4,65560
"572",2018,13,"New York Giants","Chicago Bears","Home",30,27,3,76940
"573",2018,13,"Tampa Bay Buccaneers","Carolina Panthers","Home",24,17,7,54356
"574",2018,13,"Oakland Raiders","Kansas City Chiefs","Away",33,40,-7,57919
"575",2018,13,"Tennessee Titans","New York Jets","Home",26,22,4,64520
"576",2018,13,"Seattle Seahawks","San Francisco 49ers","Home",43,16,27,69001
"577",2018,13,"New England Patriots","Minnesota Vikings","Home",24,10,14,65878
"578",2018,13,"Pittsburgh Steelers","Los Angeles Chargers","Away",30,33,-3,63456
"579",2018,13,"Philadelphia Eagles","Washington Redskins","Home",28,13,15,69696
"580",2018,14,"Tennessee Titans","Jacksonville Jaguars","Home",30,9,21,64520
"581",2018,14,"Buffalo Bills","New York Jets","Away",23,27,-4,64961
"582",2018,14,"Washington Redskins","New York Giants","Away",16,40,-24,61028
"583",2018,14,"Cleveland Browns","Carolina Panthers","Home",26,20,6,65765
"584",2018,14,"Green Bay Packers","Atlanta Falcons","Home",34,20,14,77834
"585",2018,14,"Miami Dolphins","New England Patriots","Home",34,33,1,65560
"586",2018,14,"Houston Texans","Indianapolis Colts","Away",21,24,-3,71804
"587",2018,14,"Kansas City Chiefs","Baltimore Ravens","Home",27,24,3,75972
"588",2018,14,"Tampa Bay Buccaneers","New Orleans Saints","Away",14,28,-14,54356
"589",2018,14,"San Francisco 49ers","Denver Broncos","Home",20,14,6,69148
"590",2018,14,"Los Angeles Chargers","Cincinnati Bengals","Home",26,21,5,32768
"591",2018,14,"Dallas Cowboys","Philadelphia Eagles","Home",29,23,6,91619
"592",2018,14,"Oakland Raiders","Pittsburgh Steelers","Home",24,21,3,57919
"593",2018,14,"Arizona Cardinals","Detroit Lions","Away",3,17,-14,62013
"594",2018,14,"Chicago Bears","Los Angeles Rams","Home",15,6,9,61815
"595",2018,14,"Seattle Seahawks","Minnesota Vikings","Home",21,7,14,69001
"596",2018,15,"Kansas City Chiefs","Los Angeles Chargers","Away",28,29,-1,75972
"597",2018,15,"New York Jets","Houston Texans","Away",22,29,-7,77982
"598",2018,15,"Denver Broncos","Cleveland Browns","Away",16,17,-1,76446
"599",2018,15,"Buffalo Bills","Detroit Lions","Home",14,13,1,64961
"600",2018,15,"New York Giants","Tennessee Titans","Away",0,17,-17,76940
"601",2018,15,"Chicago Bears","Green Bay Packers","Home",24,17,7,61815
"602",2018,15,"Jacksonville Jaguars","Washington Redskins","Away",13,16,-3,66674
"603",2018,15,"Cincinnati Bengals","Oakland Raiders","Home",30,16,14,50753
"604",2018,15,"Baltimore Ravens","Tampa Bay Buccaneers","Home",20,12,8,70431
"605",2018,15,"Atlanta Falcons","Arizona Cardinals","Home",40,14,26,72898
"606",2018,15,"Minnesota Vikings","Miami Dolphins","Home",41,17,24,66811
"607",2018,15,"Indianapolis Colts","Dallas Cowboys","Home",23,0,23,59199
"608",2018,15,"San Francisco 49ers","Seattle Seahawks","Home",26,23,3,69148
"609",2018,15,"Pittsburgh Steelers","New England Patriots","Home",17,10,7,63456
"610",2018,15,"Los Angeles Rams","Philadelphia Eagles","Away",23,30,-7,72429
"611",2018,15,"Carolina Panthers","New Orleans Saints","Away",9,12,-3,73772
"612",2018,16,"Tennessee Titans","Washington Redskins","Home",25,16,9,64520
"613",2018,16,"Los Angeles Chargers","Baltimore Ravens","Away",10,22,-12,32768
"614",2018,16,"Carolina Panthers","Atlanta Falcons","Away",10,24,-14,73772
"615",2018,16,"New York Jets","Green Bay Packers","Away",38,44,-6,77982
"616",2018,16,"Indianapolis Colts","New York Giants","Home",28,27,1,59199
"617",2018,16,"Dallas Cowboys","Tampa Bay Buccaneers","Home",27,20,7,91619
"618",2018,16,"Detroit Lions","Minnesota Vikings","Away",9,27,-18,62795
"619",2018,16,"New England Patriots","Buffalo Bills","Home",24,12,12,65878
"620",2018,16,"Philadelphia Eagles","Houston Texans","Home",32,30,2,69696
"621",2018,16,"Miami Dolphins","Jacksonville Jaguars","Away",7,17,-10,65560
"622",2018,16,"Cleveland Browns","Cincinnati Bengals","Home",26,18,8,65765
"623",2018,16,"San Francisco 49ers","Chicago Bears","Away",9,14,-5,69148
"624",2018,16,"Arizona Cardinals","Los Angeles Rams","Away",9,31,-22,62013
"625",2018,16,"New Orleans Saints","Pittsburgh Steelers","Home",31,28,3,73051
"626",2018,16,"Seattle Seahawks","Kansas City Chiefs","Home",38,31,7,69001
"627",2018,16,"Oakland Raiders","Denver Broncos","Home",27,14,13,57919
"628",2018,17,"Houston Texans","Jacksonville Jaguars","Home",20,3,17,71804
"629",2018,17,"Tampa Bay Buccaneers","Atlanta Falcons","Away",32,34,-2,54356
"630",2018,17,"New York Giants","Dallas Cowboys","Away",35,36,-1,76940
"631",2018,17,"Green Bay Packers","Detroit Lions","Away",0,31,-31,77834
"632",2018,17,"New Orleans Saints","Carolina Panthers","Away",14,33,-19,73051
"633",2018,17,"Buffalo Bills","Miami Dolphins","Home",42,17,25,64961
"634",2018,17,"New England Patriots","New York Jets","Home",38,3,35,65878
"635",2018,17,"Minnesota Vikings","Chicago Bears","Away",10,24,-14,66811
"636",2018,17,"Seattle Seahawks","Arizona Cardinals","Home",27,24,3,69001
"637",2018,17,"Pittsburgh Steelers","Cincinnati Bengals","Home",16,13,3,63456
"638",2018,17,"Los Angeles Rams","San Francisco 49ers","Home",48,32,16,72429
"639",2018,17,"Baltimore Ravens","Cleveland Browns","Home",26,24,2,70431
"640",2018,17,"Kansas City Chiefs","Oakland Raiders","Home",35,3,32,75972
"641",2018,17,"Washington Redskins","Philadelphia Eagles","Away",0,24,-24,61028
"642",2018,17,"Denver Broncos","Los Angeles Chargers","Away",9,23,-14,76446
"643",2018,17,"Tennessee Titans","Indianapolis Colts","Away",17,33,-16,64520
"644",2018,NA,NA,NA,NA,NA,NA,NA,NA
"645",2018,NA,"Houston Texans","Indianapolis Colts","Away",7,21,-14,71804
"646",2018,NA,"Dallas Cowboys","Seattle Seahawks","Home",24,22,2,91619
"647",2018,NA,"Baltimore Ravens","Los Angeles Chargers","Away",17,23,-6,70431
"648",2018,NA,"Chicago Bears","Philadelphia Eagles","Away",15,16,-1,61815
"649",2018,NA,"Kansas City Chiefs","Indianapolis Colts","Home",31,13,18,75972
"650",2018,NA,"Los Angeles Rams","Dallas Cowboys","Home",30,22,8,72429
"651",2018,NA,"New England Patriots","Los Angeles Chargers","Home",41,28,13,65878
"652",2018,NA,"New Orleans Saints","Philadelphia Eagles","Home",20,14,6,73051
"653",2018,NA,"New Orleans Saints","Los Angeles Rams","Away",23,26,-3,73051
"654",2018,NA,"Kansas City Chiefs","New England Patriots","Away",31,37,-6,75972
"655",2018,NA,"Los Angeles Rams","New England Patriots","Away",3,13,-10,72429
"656",2017,1,"New England Patriots","Kansas City Chiefs","Away",27,42,-15,65878
"657",2017,1,"Tennessee Titans","Oakland Raiders","Away",16,26,-10,65651
"658",2017,1,"Chicago Bears","Atlanta Falcons","Away",17,23,-6,61142
"659",2017,1,"Buffalo Bills","New York Jets","Home",21,12,9,66775
"660",2017,1,"Cleveland Browns","Pittsburgh Steelers","Away",18,21,-3,63882
"661",2017,1,"Cincinnati Bengals","Baltimore Ravens","Away",0,20,-20,53275
"662",2017,1,"Washington Redskins","Philadelphia Eagles","Away",17,30,-13,75175
"663",2017,1,"Detroit Lions","Arizona Cardinals","Home",35,23,12,64137
"664",2017,1,"Houston Texans","Jacksonville Jaguars","Away",7,29,-22,71774
"665",2017,1,"Los Angeles Rams","Indianapolis Colts","Home",46,9,37,63392
"666",2017,1,"San Francisco 49ers","Carolina Panthers","Away",3,23,-20,70144
"667",2017,1,"Green Bay Packers","Seattle Seahawks","Home",17,9,8,78092
"668",2017,1,"Dallas Cowboys","New York Giants","Home",19,3,16,92721
"669",2017,1,"Minnesota Vikings","New Orleans Saints","Home",29,19,10,66721
"670",2017,1,"Denver Broncos","Los Angeles Chargers","Home",24,21,3,76355
"671",2017,2,"Cincinnati Bengals","Houston Texans","Away",9,13,-4,53275
"672",2017,2,"Kansas City Chiefs","Philadelphia Eagles","Home",27,20,7,74106
"673",2017,2,"Indianapolis Colts","Arizona Cardinals","Away",13,16,-3,63440
"674",2017,2,"Carolina Panthers","Buffalo Bills","Home",9,3,6,73617
"675",2017,2,"New Orleans Saints","New England Patriots","Away",20,36,-16,73139
"676",2017,2,"Pittsburgh Steelers","Minnesota Vikings","Home",26,9,17,62471
"677",2017,2,"Tampa Bay Buccaneers","Chicago Bears","Home",29,7,22,59952
"678",2017,2,"Baltimore Ravens","Cleveland Browns","Home",24,10,14,70588
"679",2017,2,"Jacksonville Jaguars","Tennessee Titans","Away",16,37,-21,64303
"680",2017,2,"Los Angeles Chargers","Miami Dolphins","Away",17,19,-2,25335
"681",2017,2,"Oakland Raiders","New York Jets","Home",45,20,25,57775
"682",2017,2,"Seattle Seahawks","San Francisco 49ers","Home",12,9,3,68976
"683",2017,2,"Denver Broncos","Dallas Cowboys","Home",42,17,25,76355
"684",2017,2,"Los Angeles Rams","Washington Redskins","Away",20,27,-7,63392
"685",2017,2,"Atlanta Falcons","Green Bay Packers","Home",34,23,11,71960
"686",2017,2,"New York Giants","Detroit Lions","Away",10,24,-14,77179
"687",2017,3,"San Francisco 49ers","Los Angeles Rams","Away",39,41,-2,70144
"688",2017,3,"Jacksonville Jaguars","Baltimore Ravens","Home",44,7,37,64303
"689",2017,3,"New York Jets","Miami Dolphins","Home",20,6,14,77562
"690",2017,3,"Indianapolis Colts","Cleveland Browns","Home",31,28,3,63440
"691",2017,3,"New England Patriots","Houston Texans","Home",36,33,3,65878
"692",2017,3,"Philadelphia Eagles","New York Giants","Home",27,24,3,69596
"693",2017,3,"Detroit Lions","Atlanta Falcons","Away",26,30,-4,64137
"694",2017,3,"Buffalo Bills","Denver Broncos","Home",26,16,10,66775
"695",2017,3,"Minnesota Vikings","Tampa Bay Buccaneers","Home",34,17,17,66721
"696",2017,3,"Chicago Bears","Pittsburgh Steelers","Home",23,17,6,61142
"697",2017,3,"Carolina Panthers","New Orleans Saints","Away",13,34,-21,73617
"698",2017,3,"Tennessee Titans","Seattle Seahawks","Home",33,27,6,65651
"699",2017,3,"Green Bay Packers","Cincinnati Bengals","Home",27,24,3,78092
"700",2017,3,"Los Angeles Chargers","Kansas City Chiefs","Away",10,24,-14,25335
"701",2017,3,"Washington Redskins","Oakland Raiders","Home",27,10,17,75175
"702",2017,3,"Arizona Cardinals","Dallas Cowboys","Away",17,28,-11,64217
"703",2017,4,"Green Bay Packers","Chicago Bears","Home",35,14,21,78092
"704",2017,4,"Miami Dolphins","New Orleans Saints","Away",0,20,-20,67627
"705",2017,4,"New England Patriots","Carolina Panthers","Away",30,33,-3,65878
"706",2017,4,"Houston Texans","Tennessee Titans","Home",57,14,43,71774
"707",2017,4,"Cleveland Browns","Cincinnati Bengals","Away",7,31,-24,63882
"708",2017,4,"New York Jets","Jacksonville Jaguars","Home",23,20,3,77562
"709",2017,4,"Dallas Cowboys","Los Angeles Rams","Away",30,35,-5,92721
"710",2017,4,"Minnesota Vikings","Detroit Lions","Away",7,14,-7,66721
"711",2017,4,"Baltimore Ravens","Pittsburgh Steelers","Away",9,26,-17,70588
"712",2017,4,"Atlanta Falcons","Buffalo Bills","Away",17,23,-6,71960
"713",2017,4,"Los Angeles Chargers","Philadelphia Eagles","Away",24,26,-2,25335
"714",2017,4,"Arizona Cardinals","San Francisco 49ers","Home",18,15,3,64217
"715",2017,4,"Tampa Bay Buccaneers","New York Giants","Home",25,23,2,59952
"716",2017,4,"Denver Broncos","Oakland Raiders","Home",16,10,6,76355
"717",2017,4,"Seattle Seahawks","Indianapolis Colts","Home",46,18,28,68976
"718",2017,4,"Kansas City Chiefs","Washington Redskins","Home",29,20,9,74106
"719",2017,5,"Tampa Bay Buccaneers","New England Patriots","Away",14,19,-5,59952
"720",2017,5,"Miami Dolphins","Tennessee Titans","Home",16,10,6,67627
"721",2017,5,"Indianapolis Colts","San Francisco 49ers","Home",26,23,3,63440
"722",2017,5,"Cincinnati Bengals","Buffalo Bills","Home",20,16,4,53275
"723",2017,5,"Cleveland Browns","New York Jets","Away",14,17,-3,63882
"724",2017,5,"Detroit Lions","Carolina Panthers","Away",24,27,-3,64137
"725",2017,5,"Philadelphia Eagles","Arizona Cardinals","Home",34,7,27,69596
"726",2017,5,"Pittsburgh Steelers","Jacksonville Jaguars","Away",9,30,-21,62471
"727",2017,5,"New York Giants","Los Angeles Chargers","Away",22,27,-5,77179
"728",2017,5,"Oakland Raiders","Baltimore Ravens","Away",17,30,-13,57775
"729",2017,5,"Los Angeles Rams","Seattle Seahawks","Away",10,16,-6,63392
"730",2017,5,"Dallas Cowboys","Green Bay Packers","Away",31,35,-4,92721
"731",2017,5,"Houston Texans","Kansas City Chiefs","Away",34,42,-8,71774
"732",2017,5,"Chicago Bears","Minnesota Vikings","Away",17,20,-3,61142
"733",2017,6,"Carolina Panthers","Philadelphia Eagles","Away",23,28,-5,73617
"734",2017,6,"Atlanta Falcons","Miami Dolphins","Away",17,20,-3,71960
"735",2017,6,"Minnesota Vikings","Green Bay Packers","Home",23,10,13,66721
"736",2017,6,"New York Jets","New England Patriots","Away",17,24,-7,77562
"737",2017,6,"Houston Texans","Cleveland Browns","Home",33,17,16,71774
"738",2017,6,"Baltimore Ravens","Chicago Bears","Away",24,27,-3,70588
"739",2017,6,"New Orleans Saints","Detroit Lions","Home",52,38,14,73139
"740",2017,6,"Washington Redskins","San Francisco 49ers","Home",26,24,2,75175
"741",2017,6,"Jacksonville Jaguars","Los Angeles Rams","Away",17,27,-10,64303
"742",2017,6,"Arizona Cardinals","Tampa Bay Buccaneers","Home",38,33,5,64217
"743",2017,6,"Kansas City Chiefs","Pittsburgh Steelers","Away",13,19,-6,74106
"744",2017,6,"Oakland Raiders","Los Angeles Chargers","Away",16,17,-1,57775
"745",2017,6,"Denver Broncos","New York Giants","Away",10,23,-13,76355
"746",2017,6,"Tennessee Titans","Indianapolis Colts","Home",36,22,14,65651
"747",2017,7,"Oakland Raiders","Kansas City Chiefs","Home",31,30,1,57775
"748",2017,7,"Buffalo Bills","Tampa Bay Buccaneers","Home",30,27,3,66775
"749",2017,7,"Miami Dolphins","New York Jets","Home",31,28,3,67627
"750",2017,7,"Minnesota Vikings","Baltimore Ravens","Home",24,16,8,66721
"751",2017,7,"Chicago Bears","Carolina Panthers","Home",17,3,14,61142
"752",2017,7,"Los Angeles Rams","Arizona Cardinals","Home",33,0,33,63392
"753",2017,7,"Green Bay Packers","New Orleans Saints","Away",17,26,-9,78092
"754",2017,7,"Indianapolis Colts","Jacksonville Jaguars","Away",0,27,-27,63440
"755",2017,7,"Cleveland Browns","Tennessee Titans","Away",9,12,-3,63882
"756",2017,7,"San Francisco 49ers","Dallas Cowboys","Away",10,40,-30,70144
"757",2017,7,"Pittsburgh Steelers","Cincinnati Bengals","Home",29,14,15,62471
"758",2017,7,"Los Angeles Chargers","Denver Broncos","Home",21,0,21,25335
"759",2017,7,"New York Giants","Seattle Seahawks","Away",7,24,-17,77179
"760",2017,7,"New England Patriots","Atlanta Falcons","Home",23,7,16,65878
"761",2017,7,"Philadelphia Eagles","Washington Redskins","Home",34,24,10,69596
"762",2017,8,"Baltimore Ravens","Miami Dolphins","Home",40,0,40,70588
"763",2017,8,"Cleveland Browns","Minnesota Vikings","Away",16,33,-17,63882
"764",2017,8,"Buffalo Bills","Oakland Raiders","Home",34,14,20,66775
"765",2017,8,"New York Jets","Atlanta Falcons","Away",20,25,-5,77562
"766",2017,8,"Cincinnati Bengals","Indianapolis Colts","Home",24,23,1,53275
"767",2017,8,"New Orleans Saints","Chicago Bears","Home",20,12,8,73139
"768",2017,8,"Tampa Bay Buccaneers","Carolina Panthers","Away",3,17,-14,59952
"769",2017,8,"Philadelphia Eagles","San Francisco 49ers","Home",33,10,23,69596
"770",2017,8,"New England Patriots","Los Angeles Chargers","Home",21,13,8,65878
"771",2017,8,"Seattle Seahawks","Houston Texans","Home",41,38,3,68976
"772",2017,8,"Washington Redskins","Dallas Cowboys","Away",19,33,-14,75175
"773",2017,8,"Detroit Lions","Pittsburgh Steelers","Away",15,20,-5,64137
"774",2017,8,"Kansas City Chiefs","Denver Broncos","Home",29,19,10,74106
"775",2017,9,"New York Jets","Buffalo Bills","Home",34,21,13,77562
"776",2017,9,"Carolina Panthers","Atlanta Falcons","Home",20,17,3,73617
"777",2017,9,"Jacksonville Jaguars","Cincinnati Bengals","Home",23,7,16,64303
"778",2017,9,"Philadelphia Eagles","Denver Broncos","Home",51,23,28,69596
"779",2017,9,"New York Giants","Los Angeles Rams","Away",17,51,-34,77179
"780",2017,9,"Tennessee Titans","Baltimore Ravens","Home",23,20,3,65651
"781",2017,9,"New Orleans Saints","Tampa Bay Buccaneers","Home",30,10,20,73139
"782",2017,9,"Houston Texans","Indianapolis Colts","Away",14,20,-6,71774
"783",2017,9,"Seattle Seahawks","Washington Redskins","Away",14,17,-3,68976
"784",2017,9,"San Francisco 49ers","Arizona Cardinals","Away",10,20,-10,70144
"785",2017,9,"Dallas Cowboys","Kansas City Chiefs","Home",28,17,11,92721
"786",2017,9,"Miami Dolphins","Oakland Raiders","Away",24,27,-3,67627
"787",2017,9,"Green Bay Packers","Detroit Lions","Away",17,30,-13,78092
"788",2017,10,"Arizona Cardinals","Seattle Seahawks","Away",16,22,-6,64217
"789",2017,10,"Buffalo Bills","New Orleans Saints","Away",10,47,-37,66775
"790",2017,10,"Chicago Bears","Green Bay Packers","Away",16,23,-7,61142
"791",2017,10,"Jacksonville Jaguars","Los Angeles Chargers","Home",20,17,3,64303
"792",2017,10,"Washington Redskins","Minnesota Vikings","Away",30,38,-8,75175
"793",2017,10,"Detroit Lions","Cleveland Browns","Home",38,24,14,64137
"794",2017,10,"Tennessee Titans","Cincinnati Bengals","Home",24,20,4,65651
"795",2017,10,"Indianapolis Colts","Pittsburgh Steelers","Away",17,20,-3,63440
"796",2017,10,"Tampa Bay Buccaneers","New York Jets","Home",15,10,5,59952
"797",2017,10,"Los Angeles Rams","Houston Texans","Home",33,7,26,63392
"798",2017,10,"Atlanta Falcons","Dallas Cowboys","Home",27,7,20,71960
"799",2017,10,"San Francisco 49ers","New York Giants","Home",31,21,10,70144
"800",2017,10,"Denver Broncos","New England Patriots","Away",16,41,-25,76355
"801",2017,10,"Carolina Panthers","Miami Dolphins","Home",45,21,24,73617
"802",2017,11,"Pittsburgh Steelers","Tennessee Titans","Home",40,17,23,62471
"803",2017,11,"New Orleans Saints","Washington Redskins","Home",34,31,3,73139
"804",2017,11,"Houston Texans","Arizona Cardinals","Home",31,21,10,71774
"805",2017,11,"Miami Dolphins","Tampa Bay Buccaneers","Away",20,30,-10,67627
"806",2017,11,"Chicago Bears","Detroit Lions","Away",24,27,-3,61142
"807",2017,11,"Minnesota Vikings","Los Angeles Rams","Home",24,7,17,66721
"808",2017,11,"New York Giants","Kansas City Chiefs","Home",12,9,3,77179
"809",2017,11,"Green Bay Packers","Baltimore Ravens","Away",0,23,-23,78092
"810",2017,11,"Cleveland Browns","Jacksonville Jaguars","Away",7,19,-12,63882
"811",2017,11,"Los Angeles Chargers","Buffalo Bills","Home",54,24,30,25335
"812",2017,11,"Oakland Raiders","New England Patriots","Away",8,33,-25,57775
"813",2017,11,"Denver Broncos","Cincinnati Bengals","Away",17,20,-3,76355
"814",2017,11,"Dallas Cowboys","Philadelphia Eagles","Away",9,37,-28,92721
"815",2017,11,"Seattle Seahawks","Atlanta Falcons","Away",31,34,-3,68976
"816",2017,12,"Detroit Lions","Minnesota Vikings","Away",23,30,-7,64137
"817",2017,12,"Dallas Cowboys","Los Angeles Chargers","Away",6,28,-22,92721
"818",2017,12,"Washington Redskins","New York Giants","Home",20,10,10,75175
"819",2017,12,"Cincinnati Bengals","Cleveland Browns","Home",30,16,14,53275
"820",2017,12,"Indianapolis Colts","Tennessee Titans","Away",16,20,-4,63440
"821",2017,12,"New England Patriots","Miami Dolphins","Home",35,17,18,65878
"822",2017,12,"Kansas City Chiefs","Buffalo Bills","Away",10,16,-6,74106
"823",2017,12,"Philadelphia Eagles","Chicago Bears","Home",31,3,28,69596
"824",2017,12,"Atlanta Falcons","Tampa Bay Buccaneers","Home",34,20,14,71960
"825",2017,12,"New York Jets","Carolina Panthers","Away",27,35,-8,77562
"826",2017,12,"San Francisco 49ers","Seattle Seahawks","Away",13,24,-11,70144
"827",2017,12,"Los Angeles Rams","New Orleans Saints","Home",26,20,6,63392
"828",2017,12,"Arizona Cardinals","Jacksonville Jaguars","Home",27,24,3,64217
"829",2017,12,"Oakland Raiders","Denver Broncos","Home",21,14,7,57775
"830",2017,12,"Pittsburgh Steelers","Green Bay Packers","Home",31,28,3,62471
"831",2017,12,"Baltimore Ravens","Houston Texans","Home",23,16,7,70588
"832",2017,13,"Dallas Cowboys","Washington Redskins","Home",38,14,24,92721
"833",2017,13,"Buffalo Bills","New England Patriots","Away",3,23,-20,66775
"834",2017,13,"New York Jets","Kansas City Chiefs","Home",38,31,7,77562
"835",2017,13,"Baltimore Ravens","Detroit Lions","Home",44,20,24,70588
"836",2017,13,"Chicago Bears","San Francisco 49ers","Away",14,15,-1,61142
"837",2017,13,"Atlanta Falcons","Minnesota Vikings","Away",9,14,-5,71960
"838",2017,13,"Miami Dolphins","Denver Broncos","Home",35,9,26,67627
"839",2017,13,"Green Bay Packers","Tampa Bay Buccaneers","Home",26,20,6,78092
"840",2017,13,"Jacksonville Jaguars","Indianapolis Colts","Home",30,10,20,64303
"841",2017,13,"Tennessee Titans","Houston Texans","Home",24,13,11,65651
"842",2017,13,"Los Angeles Chargers","Cleveland Browns","Home",19,10,9,25335
"843",2017,13,"New Orleans Saints","Carolina Panthers","Home",31,21,10,73139
"844",2017,13,"Oakland Raiders","New York Giants","Home",24,17,7,57775
"845",2017,13,"Arizona Cardinals","Los Angeles Rams","Away",16,32,-16,64217
"846",2017,13,"Seattle Seahawks","Philadelphia Eagles","Home",24,10,14,68976
"847",2017,13,"Cincinnati Bengals","Pittsburgh Steelers","Away",20,23,-3,53275
"848",2017,14,"Atlanta Falcons","New Orleans Saints","Home",20,17,3,71960
"849",2017,14,"Houston Texans","San Francisco 49ers","Away",16,26,-10,71774
"850",2017,14,"Buffalo Bills","Indianapolis Colts","Home",13,7,6,66775
"851",2017,14,"Kansas City Chiefs","Oakland Raiders","Home",26,15,11,74106
"852",2017,14,"Cleveland Browns","Green Bay Packers","Away",21,27,-6,63882
"853",2017,14,"Tampa Bay Buccaneers","Detroit Lions","Away",21,24,-3,59952
"854",2017,14,"Cincinnati Bengals","Chicago Bears","Away",7,33,-26,53275
"855",2017,14,"Carolina Panthers","Minnesota Vikings","Home",31,24,7,73617
"856",2017,14,"New York Giants","Dallas Cowboys","Away",10,30,-20,77179
"857",2017,14,"Denver Broncos","New York Jets","Home",23,0,23,76355
"858",2017,14,"Los Angeles Chargers","Washington Redskins","Home",30,13,17,25335
"859",2017,14,"Arizona Cardinals","Tennessee Titans","Home",12,7,5,64217
"860",2017,14,"Los Angeles Rams","Philadelphia Eagles","Away",35,43,-8,63392
"861",2017,14,"Jacksonville Jaguars","Seattle Seahawks","Home",30,24,6,64303
"862",2017,14,"Pittsburgh Steelers","Baltimore Ravens","Home",39,38,1,62471
"863",2017,14,"Miami Dolphins","New England Patriots","Home",27,20,7,67627
"864",2017,15,"Indianapolis Colts","Denver Broncos","Away",13,25,-12,63440
"865",2017,15,"Detroit Lions","Chicago Bears","Home",20,10,10,64137
"866",2017,15,"Kansas City Chiefs","Los Angeles Chargers","Home",30,13,17,74106
"867",2017,15,"Washington Redskins","Arizona Cardinals","Home",20,15,5,75175
"868",2017,15,"Jacksonville Jaguars","Houston Texans","Home",45,7,38,64303
"869",2017,15,"Buffalo Bills","Miami Dolphins","Home",24,16,8,66775
"870",2017,15,"Cleveland Browns","Baltimore Ravens","Away",10,27,-17,63882
"871",2017,15,"New Orleans Saints","New York Jets","Home",31,19,12,73139
"872",2017,15,"Minnesota Vikings","Cincinnati Bengals","Home",34,7,27,66721
"873",2017,15,"New York Giants","Philadelphia Eagles","Away",29,34,-5,77179
"874",2017,15,"Carolina Panthers","Green Bay Packers","Home",31,24,7,73617
"875",2017,15,"Seattle Seahawks","Los Angeles Rams","Away",7,42,-35,68976
"876",2017,15,"San Francisco 49ers","Tennessee Titans","Home",25,23,2,70144
"877",2017,15,"Pittsburgh Steelers","New England Patriots","Away",24,27,-3,62471
"878",2017,15,"Oakland Raiders","Dallas Cowboys","Away",17,20,-3,57775
"879",2017,15,"Tampa Bay Buccaneers","Atlanta Falcons","Away",21,24,-3,59952
"880",2017,16,"Baltimore Ravens","Indianapolis Colts","Home",23,16,7,70588
"881",2017,16,"Green Bay Packers","Minnesota Vikings","Away",0,16,-16,78092
"882",2017,16,"Chicago Bears","Cleveland Browns","Home",20,3,17,61142
"883",2017,16,"New Orleans Saints","Atlanta Falcons","Home",23,13,10,73139
"884",2017,16,"Carolina Panthers","Tampa Bay Buccaneers","Home",22,19,3,73617
"885",2017,16,"Tennessee Titans","Los Angeles Rams","Away",23,27,-4,65651
"886",2017,16,"New York Jets","Los Angeles Chargers","Away",7,14,-7,77562
"887",2017,16,"Washington Redskins","Denver Broncos","Home",27,11,16,75175
"888",2017,16,"New England Patriots","Buffalo Bills","Home",37,16,21,65878
"889",2017,16,"Kansas City Chiefs","Miami Dolphins","Home",29,13,16,74106
"890",2017,16,"Cincinnati Bengals","Detroit Lions","Home",26,17,9,53275
"891",2017,16,"San Francisco 49ers","Jacksonville Jaguars","Home",44,33,11,70144
"892",2017,16,"Dallas Cowboys","Seattle Seahawks","Away",12,21,-9,92721
"893",2017,16,"Arizona Cardinals","New York Giants","Home",23,0,23,64217
"894",2017,16,"Houston Texans","Pittsburgh Steelers","Away",6,34,-28,71774
"895",2017,16,"Philadelphia Eagles","Oakland Raiders","Home",19,10,9,69596
"896",2017,17,"Minnesota Vikings","Chicago Bears","Home",23,10,13,66721
"897",2017,17,"Indianapolis Colts","Houston Texans","Home",22,13,9,63440
"898",2017,17,"New England Patriots","New York Jets","Home",26,6,20,65878
"899",2017,17,"Detroit Lions","Green Bay Packers","Home",35,11,24,64137
"900",2017,17,"Philadelphia Eagles","Dallas Cowboys","Away",0,6,-6,69596
"901",2017,17,"Pittsburgh Steelers","Cleveland Browns","Home",28,24,4,62471
"902",2017,17,"New York Giants","Washington Redskins","Home",18,10,8,77179
"903",2017,17,"Denver Broncos","Kansas City Chiefs","Away",24,27,-3,76355
"904",2017,17,"Los Angeles Chargers","Oakland Raiders","Home",30,10,20,25335
"905",2017,17,"Miami Dolphins","Buffalo Bills","Away",16,22,-6,67627
"906",2017,17,"Tennessee Titans","Jacksonville Jaguars","Home",15,10,5,65651
"907",2017,17,"Baltimore Ravens","Cincinnati Bengals","Away",27,31,-4,70588
"908",2017,17,"Atlanta Falcons","Carolina Panthers","Home",22,10,12,71960
"909",2017,17,"Los Angeles Rams","San Francisco 49ers","Away",13,34,-21,63392
"910",2017,17,"Seattle Seahawks","Arizona Cardinals","Away",24,26,-2,68976
"911",2017,17,"Tampa Bay Buccaneers","New Orleans Saints","Home",31,24,7,59952
"912",2017,NA,NA,NA,NA,NA,NA,NA,NA
"913",2017,NA,"Kansas City Chiefs","Tennessee Titans","Away",21,22,-1,74106
"914",2017,NA,"Los Angeles Rams","Atlanta Falcons","Away",13,26,-13,63392
"915",2017,NA,"Jacksonville Jaguars","Buffalo Bills","Home",10,3,7,64303
"916",2017,NA,"New Orleans Saints","Carolina Panthers","Home",31,26,5,73139
"917",2017,NA,"Philadelphia Eagles","Atlanta Falcons","Home",15,10,5,69596
"918",2017,NA,"New England Patriots","Tennessee Titans","Home",35,14,21,65878
"919",2017,NA,"Pittsburgh Steelers","Jacksonville Jaguars","Away",42,45,-3,62471
"920",2017,NA,"Minnesota Vikings","New Orleans Saints","Home",29,24,5,66721
"921",2017,NA,"New England Patriots","Jacksonville Jaguars","Home",24,20,4,65878
"922",2017,NA,"Philadelphia Eagles","Minnesota Vikings","Home",38,7,31,69596
"923",2017,NA,"New England Patriots","Philadelphia Eagles","Away",33,41,-8,65878
"924",2016,1,"Denver Broncos","Carolina Panthers","Home",21,20,1,76774
"925",2016,1,"Jacksonville Jaguars","Green Bay Packers","Away",23,27,-4,61915
"926",2016,1,"Baltimore Ravens","Buffalo Bills","Home",13,7,6,71102
"927",2016,1,"Kansas City Chiefs","San Diego Chargers","Home",33,27,6,73328
"928",2016,1,"Atlanta Falcons","Tampa Bay Buccaneers","Away",24,31,-7,69999
"929",2016,1,"Tennessee Titans","Minnesota Vikings","Away",16,25,-9,64659
"930",2016,1,"New Orleans Saints","Oakland Raiders","Away",34,35,-1,73109
"931",2016,1,"New York Jets","Cincinnati Bengals","Away",22,23,-1,78160
"932",2016,1,"Philadelphia Eagles","Cleveland Browns","Home",29,10,19,69596
"933",2016,1,"Houston Texans","Chicago Bears","Home",23,14,9,71868
"934",2016,1,"Seattle Seahawks","Miami Dolphins","Home",12,10,2,69073
"935",2016,1,"Dallas Cowboys","New York Giants","Away",19,20,-1,92539
"936",2016,1,"Indianapolis Colts","Detroit Lions","Away",35,39,-4,65549
"937",2016,1,"Arizona Cardinals","New England Patriots","Away",21,23,-2,64831
"938",2016,1,"Washington Redskins","Pittsburgh Steelers","Away",16,38,-22,78304
"939",2016,1,"San Francisco 49ers","Los Angeles Rams","Home",28,0,28,70178
"940",2016,2,"Buffalo Bills","New York Jets","Away",31,37,-6,68509
"941",2016,2,"New England Patriots","Miami Dolphins","Home",31,24,7,66829
"942",2016,2,"Detroit Lions","Tennessee Titans","Away",15,16,-1,60792
"943",2016,2,"Pittsburgh Steelers","Cincinnati Bengals","Home",24,16,8,64312
"944",2016,2,"Cleveland Browns","Baltimore Ravens","Away",20,25,-5,64311
"945",2016,2,"Houston Texans","Kansas City Chiefs","Home",19,12,7,71868
"946",2016,2,"Carolina Panthers","San Francisco 49ers","Home",46,27,19,73792
"947",2016,2,"Washington Redskins","Dallas Cowboys","Away",23,27,-4,78304
"948",2016,2,"New York Giants","New Orleans Saints","Home",16,13,3,78789
"949",2016,2,"Arizona Cardinals","Tampa Bay Buccaneers","Home",40,7,33,64831
"950",2016,2,"Los Angeles Rams","Seattle Seahawks","Home",9,3,6,74121
"951",2016,2,"San Diego Chargers","Jacksonville Jaguars","Home",38,14,24,NA
"952",2016,2,"Oakland Raiders","Atlanta Falcons","Away",28,35,-7,54584
"953",2016,2,"Denver Broncos","Indianapolis Colts","Home",34,20,14,76774
"954",2016,2,"Minnesota Vikings","Green Bay Packers","Home",17,14,3,66786
"955",2016,2,"Chicago Bears","Philadelphia Eagles","Away",14,29,-15,60368
"956",2016,3,"New England Patriots","Houston Texans","Home",27,0,27,66829
"957",2016,3,"Buffalo Bills","Arizona Cardinals","Home",33,18,15,68509
"958",2016,3,"Miami Dolphins","Cleveland Browns","Home",30,24,6,65512
"959",2016,3,"Tennessee Titans","Oakland Raiders","Away",10,17,-7,64659
"960",2016,3,"Jacksonville Jaguars","Baltimore Ravens","Away",17,19,-2,61915
"961",2016,3,"Carolina Panthers","Minnesota Vikings","Away",10,22,-12,73792
"962",2016,3,"Green Bay Packers","Detroit Lions","Home",34,27,7,78215
"963",2016,3,"New York Giants","Washington Redskins","Away",27,29,-2,78789
"964",2016,3,"Cincinnati Bengals","Denver Broncos","Away",17,29,-12,60511
"965",2016,3,"Seattle Seahawks","San Francisco 49ers","Home",37,18,19,69073
"966",2016,3,"Tampa Bay Buccaneers","Los Angeles Rams","Away",32,37,-5,60624
"967",2016,3,"Philadelphia Eagles","Pittsburgh Steelers","Home",34,3,31,69596
"968",2016,3,"Indianapolis Colts","San Diego Chargers","Home",26,22,4,65549
"969",2016,3,"Kansas City Chiefs","New York Jets","Home",24,3,21,73328
"970",2016,3,"Dallas Cowboys","Chicago Bears","Home",31,17,14,92539
"971",2016,3,"New Orleans Saints","Atlanta Falcons","Away",32,45,-13,73109
"972",2016,4,"Cincinnati Bengals","Miami Dolphins","Home",22,7,15,60511
"973",2016,4,"Jacksonville Jaguars","Indianapolis Colts","Home",30,27,3,61915
"974",2016,4,"Chicago Bears","Detroit Lions","Home",17,14,3,60368
"975",2016,4,"Baltimore Ravens","Oakland Raiders","Away",27,28,-1,71102
"976",2016,4,"New England Patriots","Buffalo Bills","Away",0,16,-16,66829
"977",2016,4,"Houston Texans","Tennessee Titans","Home",27,20,7,71868
"978",2016,4,"New York Jets","Seattle Seahawks","Away",17,27,-10,78160
"979",2016,4,"Atlanta Falcons","Carolina Panthers","Home",48,33,15,69999
"980",2016,4,"Washington Redskins","Cleveland Browns","Home",31,20,11,78304
"981",2016,4,"Tampa Bay Buccaneers","Denver Broncos","Away",7,27,-20,60624
"982",2016,4,"Arizona Cardinals","Los Angeles Rams","Away",13,17,-4,64831
"983",2016,4,"San Francisco 49ers","Dallas Cowboys","Away",17,24,-7,70178
"984",2016,4,"San Diego Chargers","New Orleans Saints","Away",34,35,-1,NA
"985",2016,4,"Pittsburgh Steelers","Kansas City Chiefs","Home",43,14,29,64312
"986",2016,4,"Minnesota Vikings","New York Giants","Home",24,10,14,66786
"987",2016,5,"San Francisco 49ers","Arizona Cardinals","Away",21,33,-12,70178
"988",2016,5,"Indianapolis Colts","Chicago Bears","Home",29,23,6,65549
"989",2016,5,"Detroit Lions","Philadelphia Eagles","Home",24,23,1,60792
"990",2016,5,"Pittsburgh Steelers","New York Jets","Home",31,13,18,64312
"991",2016,5,"Miami Dolphins","Tennessee Titans","Away",17,30,-13,65512
"992",2016,5,"Cleveland Browns","New England Patriots","Away",13,33,-20,64311
"993",2016,5,"Baltimore Ravens","Washington Redskins","Away",10,16,-6,71102
"994",2016,5,"Minnesota Vikings","Houston Texans","Home",31,13,18,66786
"995",2016,5,"Denver Broncos","Atlanta Falcons","Away",16,23,-7,76774
"996",2016,5,"Oakland Raiders","San Diego Chargers","Home",34,31,3,54584
"997",2016,5,"Dallas Cowboys","Cincinnati Bengals","Home",28,14,14,92539
"998",2016,5,"Los Angeles Rams","Buffalo Bills","Away",19,30,-11,74121
"999",2016,5,"Green Bay Packers","New York Giants","Home",23,16,7,78215
"1000",2016,5,"Carolina Panthers","Tampa Bay Buccaneers","Away",14,17,-3,73792
"1001",2016,6,"San Diego Chargers","Denver Broncos","Home",21,13,8,NA
"1002",2016,6,"Tennessee Titans","Cleveland Browns","Home",28,26,2,64659
"1003",2016,6,"New York Giants","Baltimore Ravens","Home",27,23,4,78789
"1004",2016,6,"Chicago Bears","Jacksonville Jaguars","Away",16,17,-1,60368
"1005",2016,6,"Detroit Lions","Los Angeles Rams","Home",31,28,3,60792
"1006",2016,6,"Miami Dolphins","Pittsburgh Steelers","Home",30,15,15,65512
"1007",2016,6,"New England Patriots","Cincinnati Bengals","Home",35,17,18,66829
"1008",2016,6,"Buffalo Bills","San Francisco 49ers","Home",45,16,29,68509
"1009",2016,6,"Washington Redskins","Philadelphia Eagles","Home",27,20,7,78304
"1010",2016,6,"New Orleans Saints","Carolina Panthers","Home",41,38,3,73109
"1011",2016,6,"Oakland Raiders","Kansas City Chiefs","Away",10,26,-16,54584
"1012",2016,6,"Green Bay Packers","Dallas Cowboys","Away",16,30,-14,78215
"1013",2016,6,"Seattle Seahawks","Atlanta Falcons","Home",26,24,2,69073
"1014",2016,6,"Houston Texans","Indianapolis Colts","Home",26,23,3,71868
"1015",2016,6,"Arizona Cardinals","New York Jets","Home",28,3,25,64831
"1016",2016,7,"Green Bay Packers","Chicago Bears","Home",26,10,16,78215
"1017",2016,7,"Los Angeles Rams","New York Giants","Away",10,17,-7,74121
"1018",2016,7,"Jacksonville Jaguars","Oakland Raiders","Away",16,33,-17,61915
"1019",2016,7,"Philadelphia Eagles","Minnesota Vikings","Home",21,10,11,69596
"1020",2016,7,"Cincinnati Bengals","Cleveland Browns","Home",31,17,14,60511
"1021",2016,7,"Miami Dolphins","Buffalo Bills","Home",28,25,3,65512
"1022",2016,7,"Detroit Lions","Washington Redskins","Home",20,17,3,60792
"1023",2016,7,"Tennessee Titans","Indianapolis Colts","Away",26,34,-8,64659
"1024",2016,7,"Kansas City Chiefs","New Orleans Saints","Home",27,21,6,73328
"1025",2016,7,"New York Jets","Baltimore Ravens","Home",24,16,8,78160
"1026",2016,7,"Atlanta Falcons","San Diego Chargers","Away",30,33,-3,69999
"1027",2016,7,"San Francisco 49ers","Tampa Bay Buccaneers","Away",17,34,-17,70178
"1028",2016,7,"Pittsburgh Steelers","New England Patriots","Away",16,27,-11,64312
"1029",2016,7,"Arizona Cardinals","Seattle Seahawks","Away",6,6,0,64831
"1030",2016,7,"Denver Broncos","Houston Texans","Home",27,9,18,76774
"1031",2016,8,"Tennessee Titans","Jacksonville Jaguars","Home",36,22,14,64659
"1032",2016,8,"Cincinnati Bengals","Washington Redskins","Away",27,27,0,60511
"1033",2016,8,"Carolina Panthers","Arizona Cardinals","Home",30,20,10,73792
"1034",2016,8,"Cleveland Browns","New York Jets","Away",28,31,-3,64311
"1035",2016,8,"Buffalo Bills","New England Patriots","Away",25,41,-16,68509
"1036",2016,8,"Tampa Bay Buccaneers","Oakland Raiders","Away",24,30,-6,60624
"1037",2016,8,"Indianapolis Colts","Kansas City Chiefs","Away",14,30,-16,65549
"1038",2016,8,"New Orleans Saints","Seattle Seahawks","Home",25,20,5,73109
"1039",2016,8,"Houston Texans","Detroit Lions","Home",20,13,7,71868
"1040",2016,8,"Denver Broncos","San Diego Chargers","Home",27,19,8,76774
"1041",2016,8,"Atlanta Falcons","Green Bay Packers","Home",33,32,1,69999
"1042",2016,8,"Dallas Cowboys","Philadelphia Eagles","Home",29,23,6,92539
"1043",2016,8,"Chicago Bears","Minnesota Vikings","Home",20,10,10,60368
"1044",2016,9,"Tampa Bay Buccaneers","Atlanta Falcons","Away",28,43,-15,60624
"1045",2016,9,"Kansas City Chiefs","Jacksonville Jaguars","Home",19,14,5,73328
"1046",2016,9,"Baltimore Ravens","Pittsburgh Steelers","Home",21,14,7,71102
"1047",2016,9,"New York Giants","Philadelphia Eagles","Home",28,23,5,78789
"1048",2016,9,"Miami Dolphins","New York Jets","Home",27,23,4,65512
"1049",2016,9,"Minnesota Vikings","Detroit Lions","Away",16,22,-6,66786
"1050",2016,9,"Cleveland Browns","Dallas Cowboys","Away",10,35,-25,64311
"1051",2016,9,"San Francisco 49ers","New Orleans Saints","Away",23,41,-18,70178
"1052",2016,9,"Los Angeles Rams","Carolina Panthers","Away",10,13,-3,74121
"1053",2016,9,"Green Bay Packers","Indianapolis Colts","Away",26,31,-5,78215
"1054",2016,9,"San Diego Chargers","Tennessee Titans","Home",43,35,8,NA
"1055",2016,9,"Oakland Raiders","Denver Broncos","Home",30,20,10,54584
"1056",2016,9,"Seattle Seahawks","Buffalo Bills","Home",31,25,6,69073
"1057",2016,10,"Baltimore Ravens","Cleveland Browns","Home",28,7,21,71102
"1058",2016,10,"Washington Redskins","Minnesota Vikings","Home",26,20,6,78304
"1059",2016,10,"Jacksonville Jaguars","Houston Texans","Away",21,24,-3,61915
"1060",2016,10,"Tampa Bay Buccaneers","Chicago Bears","Home",36,10,26,60624
"1061",2016,10,"Carolina Panthers","Kansas City Chiefs","Away",17,20,-3,73792
"1062",2016,10,"Tennessee Titans","Green Bay Packers","Home",47,25,22,64659
"1063",2016,10,"New Orleans Saints","Denver Broncos","Away",23,25,-2,73109
"1064",2016,10,"New York Jets","Los Angeles Rams","Away",6,9,-3,78160
"1065",2016,10,"Philadelphia Eagles","Atlanta Falcons","Home",24,15,9,69596
"1066",2016,10,"San Diego Chargers","Miami Dolphins","Away",24,31,-7,NA
"1067",2016,10,"Arizona Cardinals","San Francisco 49ers","Home",23,20,3,64831
"1068",2016,10,"Pittsburgh Steelers","Dallas Cowboys","Away",30,35,-5,64312
"1069",2016,10,"New England Patriots","Seattle Seahawks","Away",24,31,-7,66829
"1070",2016,10,"New York Giants","Cincinnati Bengals","Home",21,20,1,78789
"1071",2016,11,"Carolina Panthers","New Orleans Saints","Home",23,20,3,73792
"1072",2016,11,"Cincinnati Bengals","Buffalo Bills","Away",12,16,-4,60511
"1073",2016,11,"Kansas City Chiefs","Tampa Bay Buccaneers","Away",17,19,-2,73328
"1074",2016,11,"New York Giants","Chicago Bears","Home",22,16,6,78789
"1075",2016,11,"Detroit Lions","Jacksonville Jaguars","Home",26,19,7,60792
"1076",2016,11,"Minnesota Vikings","Arizona Cardinals","Home",30,24,6,66786
"1077",2016,11,"Indianapolis Colts","Tennessee Titans","Home",24,17,7,65549
"1078",2016,11,"Dallas Cowboys","Baltimore Ravens","Home",27,17,10,92539
"1079",2016,11,"Cleveland Browns","Pittsburgh Steelers","Away",9,24,-15,64311
"1080",2016,11,"Los Angeles Rams","Miami Dolphins","Away",10,14,-4,74121
"1081",2016,11,"San Francisco 49ers","New England Patriots","Away",17,30,-13,70178
"1082",2016,11,"Seattle Seahawks","Philadelphia Eagles","Home",26,15,11,69073
"1083",2016,11,"Washington Redskins","Green Bay Packers","Home",42,24,18,78304
"1084",2016,11,"Oakland Raiders","Houston Texans","Home",27,20,7,54584
"1085",2016,12,"Detroit Lions","Minnesota Vikings","Home",16,13,3,60792
"1086",2016,12,"Dallas Cowboys","Washington Redskins","Home",31,26,5,92539
"1087",2016,12,"Indianapolis Colts","Pittsburgh Steelers","Away",7,28,-21,65549
"1088",2016,12,"Buffalo Bills","Jacksonville Jaguars","Home",28,21,7,68509
"1089",2016,12,"Houston Texans","San Diego Chargers","Away",13,21,-8,71868
"1090",2016,12,"Chicago Bears","Tennessee Titans","Away",21,27,-6,60368
"1091",2016,12,"New Orleans Saints","Los Angeles Rams","Home",49,21,28,73109
"1092",2016,12,"Miami Dolphins","San Francisco 49ers","Home",31,24,7,65512
"1093",2016,12,"Atlanta Falcons","Arizona Cardinals","Home",38,19,19,69999
"1094",2016,12,"Baltimore Ravens","Cincinnati Bengals","Home",19,14,5,71102
"1095",2016,12,"Cleveland Browns","New York Giants","Away",13,27,-14,64311
"1096",2016,12,"Tampa Bay Buccaneers","Seattle Seahawks","Home",14,5,9,60624
"1097",2016,12,"New York Jets","New England Patriots","Away",17,22,-5,78160
"1098",2016,12,"Oakland Raiders","Carolina Panthers","Home",35,32,3,54584
"1099",2016,12,"Denver Broncos","Kansas City Chiefs","Away",27,30,-3,76774
"1100",2016,12,"Philadelphia Eagles","Green Bay Packers","Away",13,27,-14,69596
"1101",2016,13,"Minnesota Vikings","Dallas Cowboys","Away",15,17,-2,66786
"1102",2016,13,"New Orleans Saints","Detroit Lions","Away",13,28,-15,73109
"1103",2016,13,"Chicago Bears","San Francisco 49ers","Home",26,6,20,60368
"1104",2016,13,"Baltimore Ravens","Miami Dolphins","Home",38,6,32,71102
"1105",2016,13,"Jacksonville Jaguars","Denver Broncos","Away",10,20,-10,61915
"1106",2016,13,"Atlanta Falcons","Kansas City Chiefs","Away",28,29,-1,69999
"1107",2016,13,"Cincinnati Bengals","Philadelphia Eagles","Home",32,14,18,60511
"1108",2016,13,"New England Patriots","Los Angeles Rams","Home",26,10,16,66829
"1109",2016,13,"Green Bay Packers","Houston Texans","Home",21,13,8,78215
"1110",2016,13,"Oakland Raiders","Buffalo Bills","Home",38,24,14,54584
"1111",2016,13,"Arizona Cardinals","Washington Redskins","Home",31,23,8,64831
"1112",2016,13,"San Diego Chargers","Tampa Bay Buccaneers","Away",21,28,-7,NA
"1113",2016,13,"Pittsburgh Steelers","New York Giants","Home",24,14,10,64312
"1114",2016,13,"Seattle Seahawks","Carolina Panthers","Home",40,7,33,69073
"1115",2016,13,"New York Jets","Indianapolis Colts","Away",10,41,-31,78160
"1116",2016,14,"Kansas City Chiefs","Oakland Raiders","Home",21,13,8,73328
"1117",2016,14,"Miami Dolphins","Arizona Cardinals","Home",26,23,3,65512
"1118",2016,14,"Carolina Panthers","San Diego Chargers","Home",28,16,12,73792
"1119",2016,14,"Detroit Lions","Chicago Bears","Home",20,17,3,60792
"1120",2016,14,"Tennessee Titans","Denver Broncos","Home",13,10,3,64659
"1121",2016,14,"Indianapolis Colts","Houston Texans","Away",17,22,-5,65549
"1122",2016,14,"Jacksonville Jaguars","Minnesota Vikings","Away",16,25,-9,61915
"1123",2016,14,"Cleveland Browns","Cincinnati Bengals","Away",10,23,-13,64311
"1124",2016,14,"Philadelphia Eagles","Washington Redskins","Away",22,27,-5,69596
"1125",2016,14,"Buffalo Bills","Pittsburgh Steelers","Away",20,27,-7,68509
"1126",2016,14,"San Francisco 49ers","New York Jets","Away",17,23,-6,70178
"1127",2016,14,"Tampa Bay Buccaneers","New Orleans Saints","Home",16,11,5,60624
"1128",2016,14,"Green Bay Packers","Seattle Seahawks","Home",38,10,28,78215
"1129",2016,14,"Los Angeles Rams","Atlanta Falcons","Away",14,42,-28,74121
"1130",2016,14,"New York Giants","Dallas Cowboys","Home",10,7,3,78789
"1131",2016,14,"New England Patriots","Baltimore Ravens","Home",30,23,7,66829
"1132",2016,15,"Seattle Seahawks","Los Angeles Rams","Home",24,3,21,69073
"1133",2016,15,"New York Jets","Miami Dolphins","Away",13,34,-21,78160
"1134",2016,15,"Buffalo Bills","Cleveland Browns","Home",33,13,20,68509
"1135",2016,15,"New York Giants","Detroit Lions","Home",17,6,11,78789
"1136",2016,15,"Chicago Bears","Green Bay Packers","Away",27,30,-3,60368
"1137",2016,15,"Minnesota Vikings","Indianapolis Colts","Away",6,34,-28,66786
"1138",2016,15,"Cincinnati Bengals","Pittsburgh Steelers","Away",20,24,-4,60511
"1139",2016,15,"Baltimore Ravens","Philadelphia Eagles","Home",27,26,1,71102
"1140",2016,15,"Houston Texans","Jacksonville Jaguars","Home",21,20,1,71868
"1141",2016,15,"Kansas City Chiefs","Tennessee Titans","Away",17,19,-2,73328
"1142",2016,15,"Arizona Cardinals","New Orleans Saints","Away",41,48,-7,64831
"1143",2016,15,"Atlanta Falcons","San Francisco 49ers","Home",41,13,28,69999
"1144",2016,15,"Denver Broncos","New England Patriots","Away",3,16,-13,76774
"1145",2016,15,"San Diego Chargers","Oakland Raiders","Away",16,19,-3,NA
"1146",2016,15,"Dallas Cowboys","Tampa Bay Buccaneers","Home",26,20,6,92539
"1147",2016,15,"Washington Redskins","Carolina Panthers","Away",15,26,-11,78304
"1148",2016,16,"Philadelphia Eagles","New York Giants","Home",24,19,5,69596
"1149",2016,16,"Carolina Panthers","Atlanta Falcons","Away",16,33,-17,73792
"1150",2016,16,"New England Patriots","New York Jets","Home",41,3,38,66829
"1151",2016,16,"Green Bay Packers","Minnesota Vikings","Home",38,25,13,78215
"1152",2016,16,"Buffalo Bills","Miami Dolphins","Away",31,34,-3,68509
"1153",2016,16,"Cleveland Browns","San Diego Chargers","Home",20,17,3,64311
"1154",2016,16,"Jacksonville Jaguars","Tennessee Titans","Home",38,17,21,61915
"1155",2016,16,"Chicago Bears","Washington Redskins","Away",21,41,-20,60368
"1156",2016,16,"Oakland Raiders","Indianapolis Colts","Home",33,25,8,54584
"1157",2016,16,"Los Angeles Rams","San Francisco 49ers","Away",21,22,-1,74121
"1158",2016,16,"New Orleans Saints","Tampa Bay Buccaneers","Home",31,24,7,73109
"1159",2016,16,"Seattle Seahawks","Arizona Cardinals","Away",31,34,-3,69073
"1160",2016,16,"Houston Texans","Cincinnati Bengals","Home",12,10,2,71868
"1161",2016,16,"Pittsburgh Steelers","Baltimore Ravens","Home",31,27,4,64312
"1162",2016,16,"Kansas City Chiefs","Denver Broncos","Home",33,10,23,73328
"1163",2016,16,"Dallas Cowboys","Detroit Lions","Home",42,21,21,92539
"1164",2016,17,"Pittsburgh Steelers","Cleveland Browns","Home",27,24,3,64312
"1165",2016,17,"Minnesota Vikings","Chicago Bears","Home",38,10,28,66786
"1166",2016,17,"Tennessee Titans","Houston Texans","Home",24,17,7,64659
"1167",2016,17,"Indianapolis Colts","Jacksonville Jaguars","Home",24,20,4,65549
"1168",2016,17,"Cincinnati Bengals","Baltimore Ravens","Home",27,10,17,60511
"1169",2016,17,"Philadelphia Eagles","Dallas Cowboys","Home",27,13,14,69596
"1170",2016,17,"Tampa Bay Buccaneers","Carolina Panthers","Home",17,16,1,60624
"1171",2016,17,"Miami Dolphins","New England Patriots","Away",14,35,-21,65512
"1172",2016,17,"New York Jets","Buffalo Bills","Home",30,10,20,78160
"1173",2016,17,"Denver Broncos","Oakland Raiders","Home",24,6,18,76774
"1174",2016,17,"San Diego Chargers","Kansas City Chiefs","Away",27,37,-10,NA
"1175",2016,17,"Atlanta Falcons","New Orleans Saints","Home",38,32,6,69999
"1176",2016,17,"Washington Redskins","New York Giants","Away",10,19,-9,78304
"1177",2016,17,"San Francisco 49ers","Seattle Seahawks","Away",23,25,-2,70178
"1178",2016,17,"Los Angeles Rams","Arizona Cardinals","Away",6,44,-38,74121
"1179",2016,17,"Detroit Lions","Green Bay Packers","Away",24,31,-7,60792
"1180",2016,NA,NA,NA,NA,NA,NA,NA,NA
"1181",2016,NA,"Houston Texans","Oakland Raiders","Home",27,14,13,71868
"1182",2016,NA,"Seattle Seahawks","Detroit Lions","Home",26,6,20,69073
"1183",2016,NA,"Pittsburgh Steelers","Miami Dolphins","Home",30,12,18,64312
"1184",2016,NA,"Green Bay Packers","New York Giants","Home",38,13,25,78215
"1185",2016,NA,"Atlanta Falcons","Seattle Seahawks","Home",36,20,16,69999
"1186",2016,NA,"New England Patriots","Houston Texans","Home",34,16,18,66829
"1187",2016,NA,"Dallas Cowboys","Green Bay Packers","Away",31,34,-3,92539
"1188",2016,NA,"Kansas City Chiefs","Pittsburgh Steelers","Away",16,18,-2,73328
"1189",2016,NA,"Atlanta Falcons","Green Bay Packers","Home",44,21,23,69999
"1190",2016,NA,"New England Patriots","Pittsburgh Steelers","Home",36,17,19,66829
"1191",2016,NA,"Atlanta Falcons","New England Patriots","Away",28,34,-6,69999
"1192",2015,1,"New England Patriots","Pittsburgh Steelers","Home",28,21,7,66829
"1193",2015,1,"St. Louis Rams","Seattle Seahawks","Home",34,31,3,NA
"1194",2015,1,"Chicago Bears","Green Bay Packers","Away",23,31,-8,62035
"1195",2015,1,"Washington Redskins","Miami Dolphins","Away",10,17,-7,76209
"1196",2015,1,"Houston Texans","Kansas City Chiefs","Away",20,27,-7,71769
"1197",2015,1,"Jacksonville Jaguars","Carolina Panthers","Away",9,20,-11,61463
"1198",2015,1,"Buffalo Bills","Indianapolis Colts","Home",27,14,13,69880
"1199",2015,1,"New York Jets","Cleveland Browns","Home",31,10,21,78160
"1200",2015,1,"San Diego Chargers","Detroit Lions","Home",33,28,5,52402
"1201",2015,1,"Arizona Cardinals","New Orleans Saints","Home",31,19,12,64185
"1202",2015,1,"Denver Broncos","Baltimore Ravens","Home",19,13,6,76922
"1203",2015,1,"Tampa Bay Buccaneers","Tennessee Titans","Away",14,42,-28,61560
"1204",2015,1,"Oakland Raiders","Cincinnati Bengals","Away",13,33,-20,54613
"1205",2015,1,"Dallas Cowboys","New York Giants","Home",27,26,1,91459
"1206",2015,1,"Atlanta Falcons","Philadelphia Eagles","Home",26,24,2,70355
"1207",2015,1,"San Francisco 49ers","Minnesota Vikings","Home",20,3,17,70799
"1208",2015,2,"Kansas City Chiefs","Denver Broncos","Away",24,31,-7,74086
"1209",2015,2,"Chicago Bears","Arizona Cardinals","Away",23,48,-25,62035
"1210",2015,2,"Cleveland Browns","Tennessee Titans","Home",28,14,14,66186
"1211",2015,2,"New York Giants","Atlanta Falcons","Away",20,24,-4,79001
"1212",2015,2,"Carolina Panthers","Houston Texans","Home",24,17,7,74056
"1213",2015,2,"New Orleans Saints","Tampa Bay Buccaneers","Away",19,26,-7,73038
"1214",2015,2,"Pittsburgh Steelers","San Francisco 49ers","Home",43,18,25,64356
"1215",2015,2,"Buffalo Bills","New England Patriots","Away",32,40,-8,69880
"1216",2015,2,"Minnesota Vikings","Detroit Lions","Home",26,16,10,52430
"1217",2015,2,"Cincinnati Bengals","San Diego Chargers","Home",24,19,5,61389
"1218",2015,2,"Washington Redskins","St. Louis Rams","Home",24,10,14,76209
"1219",2015,2,"Jacksonville Jaguars","Miami Dolphins","Home",23,20,3,61463
"1220",2015,2,"Oakland Raiders","Baltimore Ravens","Home",37,33,4,54613
"1221",2015,2,"Philadelphia Eagles","Dallas Cowboys","Away",10,20,-10,69483
"1222",2015,2,"Green Bay Packers","Seattle Seahawks","Home",27,17,10,78413
"1223",2015,2,"Indianapolis Colts","New York Jets","Away",7,20,-13,66047
"1224",2015,3,"New York Giants","Washington Redskins","Home",32,21,11,79001
"1225",2015,3,"St. Louis Rams","Pittsburgh Steelers","Away",6,12,-6,NA
"1226",2015,3,"Cleveland Browns","Oakland Raiders","Away",20,27,-7,66186
"1227",2015,3,"Minnesota Vikings","San Diego Chargers","Home",31,14,17,52430
"1228",2015,3,"Baltimore Ravens","Cincinnati Bengals","Away",24,28,-4,71002
"1229",2015,3,"Tennessee Titans","Indianapolis Colts","Away",33,35,-2,62304
"1230",2015,3,"New York Jets","Philadelphia Eagles","Away",17,24,-7,78160
"1231",2015,3,"Houston Texans","Tampa Bay Buccaneers","Home",19,9,10,71769
"1232",2015,3,"Dallas Cowboys","Atlanta Falcons","Away",28,39,-11,91459
"1233",2015,3,"Carolina Panthers","New Orleans Saints","Home",27,22,5,74056
"1234",2015,3,"New England Patriots","Jacksonville Jaguars","Home",51,17,34,66829
"1235",2015,3,"Arizona Cardinals","San Francisco 49ers","Home",47,7,40,64185
"1236",2015,3,"Miami Dolphins","Buffalo Bills","Away",14,41,-27,67193
"1237",2015,3,"Seattle Seahawks","Chicago Bears","Home",26,0,26,69020
"1238",2015,3,"Detroit Lions","Denver Broncos","Away",12,24,-12,61347
"1239",2015,3,"Green Bay Packers","Kansas City Chiefs","Home",38,28,10,78413
"1240",2015,4,"Pittsburgh Steelers","Baltimore Ravens","Away",20,23,-3,64356
"1241",2015,4,"Miami Dolphins","New York Jets","Away",14,27,-13,67193
"1242",2015,4,"Indianapolis Colts","Jacksonville Jaguars","Home",16,13,3,66047
"1243",2015,4,"Buffalo Bills","New York Giants","Away",10,24,-14,69880
"1244",2015,4,"Chicago Bears","Oakland Raiders","Home",22,20,2,62035
"1245",2015,4,"Atlanta Falcons","Houston Texans","Home",48,21,27,70355
"1246",2015,4,"Cincinnati Bengals","Kansas City Chiefs","Home",36,21,15,61389
"1247",2015,4,"Washington Redskins","Philadelphia Eagles","Home",23,20,3,76209
"1248",2015,4,"Tampa Bay Buccaneers","Carolina Panthers","Away",23,37,-14,61560
"1249",2015,4,"San Diego Chargers","Cleveland Browns","Home",30,27,3,52402
"1250",2015,4,"Arizona Cardinals","St. Louis Rams","Away",22,24,-2,64185
"1251",2015,4,"Denver Broncos","Minnesota Vikings","Home",23,20,3,76922
"1252",2015,4,"San Francisco 49ers","Green Bay Packers","Away",3,17,-14,70799
"1253",2015,4,"New Orleans Saints","Dallas Cowboys","Home",26,20,6,73038
"1254",2015,4,"Seattle Seahawks","Detroit Lions","Home",13,10,3,69020
"1255",2015,5,"Houston Texans","Indianapolis Colts","Away",20,27,-7,71769
"1256",2015,5,"Baltimore Ravens","Cleveland Browns","Away",30,33,-3,71002
"1257",2015,5,"Kansas City Chiefs","Chicago Bears","Away",17,18,-1,74086
"1258",2015,5,"Atlanta Falcons","Washington Redskins","Home",25,19,6,70355
"1259",2015,5,"Green Bay Packers","St. Louis Rams","Home",24,10,14,78413
"1260",2015,5,"Tampa Bay Buccaneers","Jacksonville Jaguars","Home",38,31,7,61560
"1261",2015,5,"Cincinnati Bengals","Seattle Seahawks","Home",27,24,3,61389
"1262",2015,5,"Tennessee Titans","Buffalo Bills","Away",13,14,-1,62304
"1263",2015,5,"Philadelphia Eagles","New Orleans Saints","Home",39,17,22,69483
"1264",2015,5,"Detroit Lions","Arizona Cardinals","Away",17,42,-25,61347
"1265",2015,5,"Oakland Raiders","Denver Broncos","Away",10,16,-6,54613
"1266",2015,5,"Dallas Cowboys","New England Patriots","Away",6,30,-24,91459
"1267",2015,5,"New York Giants","San Francisco 49ers","Home",30,27,3,79001
"1268",2015,5,"San Diego Chargers","Pittsburgh Steelers","Away",20,24,-4,52402
"1269",2015,6,"New Orleans Saints","Atlanta Falcons","Home",31,21,10,73038
"1270",2015,6,"New York Jets","Washington Redskins","Home",34,20,14,78160
"1271",2015,6,"Buffalo Bills","Cincinnati Bengals","Away",21,34,-13,69880
"1272",2015,6,"Cleveland Browns","Denver Broncos","Away",23,26,-3,66186
"1273",2015,6,"Detroit Lions","Chicago Bears","Home",37,34,3,61347
"1274",2015,6,"Jacksonville Jaguars","Houston Texans","Away",20,31,-11,61463
"1275",2015,6,"Minnesota Vikings","Kansas City Chiefs","Home",16,10,6,52430
"1276",2015,6,"Tennessee Titans","Miami Dolphins","Away",10,38,-28,62304
"1277",2015,6,"Pittsburgh Steelers","Arizona Cardinals","Home",25,13,12,64356
"1278",2015,6,"Seattle Seahawks","Carolina Panthers","Away",23,27,-4,69020
"1279",2015,6,"Green Bay Packers","San Diego Chargers","Home",27,20,7,78413
"1280",2015,6,"San Francisco 49ers","Baltimore Ravens","Home",25,20,5,70799
"1281",2015,6,"Indianapolis Colts","New England Patriots","Away",27,34,-7,66047
"1282",2015,6,"Philadelphia Eagles","New York Giants","Home",27,7,20,69483
"1283",2015,7,"San Francisco 49ers","Seattle Seahawks","Away",3,20,-17,70799
"1284",2015,7,"Jacksonville Jaguars","Buffalo Bills","Home",34,31,3,61463
"1285",2015,7,"St. Louis Rams","Cleveland Browns","Home",24,6,18,NA
"1286",2015,7,"New England Patriots","New York Jets","Home",30,23,7,66829
"1287",2015,7,"Miami Dolphins","Houston Texans","Home",44,26,18,67193
"1288",2015,7,"Tennessee Titans","Atlanta Falcons","Away",7,10,-3,62304
"1289",2015,7,"Detroit Lions","Minnesota Vikings","Away",19,28,-9,61347
"1290",2015,7,"Indianapolis Colts","New Orleans Saints","Away",21,27,-6,66047
"1291",2015,7,"Kansas City Chiefs","Pittsburgh Steelers","Home",23,13,10,74086
"1292",2015,7,"Washington Redskins","Tampa Bay Buccaneers","Home",31,30,1,76209
"1293",2015,7,"San Diego Chargers","Oakland Raiders","Away",29,37,-8,52402
"1294",2015,7,"New York Giants","Dallas Cowboys","Home",27,20,7,79001
"1295",2015,7,"Carolina Panthers","Philadelphia Eagles","Home",27,16,11,74056
"1296",2015,7,"Arizona Cardinals","Baltimore Ravens","Home",26,18,8,64185
"1297",2015,8,"New England Patriots","Miami Dolphins","Home",36,7,29,66829
"1298",2015,8,"Kansas City Chiefs","Detroit Lions","Home",45,10,35,74086
"1299",2015,8,"St. Louis Rams","San Francisco 49ers","Home",27,6,21,NA
"1300",2015,8,"Chicago Bears","Minnesota Vikings","Away",20,23,-3,62035
"1301",2015,8,"Pittsburgh Steelers","Cincinnati Bengals","Away",10,16,-6,64356
"1302",2015,8,"Houston Texans","Tennessee Titans","Home",20,6,14,71769
"1303",2015,8,"Atlanta Falcons","Tampa Bay Buccaneers","Away",20,23,-3,70355
"1304",2015,8,"New Orleans Saints","New York Giants","Home",52,49,3,73038
"1305",2015,8,"Baltimore Ravens","San Diego Chargers","Home",29,26,3,71002
"1306",2015,8,"Cleveland Browns","Arizona Cardinals","Away",20,34,-14,66186
"1307",2015,8,"Oakland Raiders","New York Jets","Home",34,20,14,54613
"1308",2015,8,"Dallas Cowboys","Seattle Seahawks","Away",12,13,-1,91459
"1309",2015,8,"Denver Broncos","Green Bay Packers","Home",29,10,19,76922
"1310",2015,8,"Carolina Panthers","Indianapolis Colts","Home",29,26,3,74056
"1311",2015,9,"Cincinnati Bengals","Cleveland Browns","Home",31,10,21,61389
"1312",2015,9,"Minnesota Vikings","St. Louis Rams","Home",21,18,3,52430
"1313",2015,9,"Buffalo Bills","Miami Dolphins","Home",33,17,16,69880
"1314",2015,9,"New England Patriots","Washington Redskins","Home",27,10,17,66829
"1315",2015,9,"New York Jets","Jacksonville Jaguars","Home",28,23,5,78160
"1316",2015,9,"New Orleans Saints","Tennessee Titans","Away",28,34,-6,73038
"1317",2015,9,"Pittsburgh Steelers","Oakland Raiders","Home",38,35,3,64356
"1318",2015,9,"Carolina Panthers","Green Bay Packers","Home",37,29,8,74056
"1319",2015,9,"Tampa Bay Buccaneers","New York Giants","Away",18,32,-14,61560
"1320",2015,9,"San Francisco 49ers","Atlanta Falcons","Home",17,16,1,70799
"1321",2015,9,"Indianapolis Colts","Denver Broncos","Home",27,24,3,66047
"1322",2015,9,"Dallas Cowboys","Philadelphia Eagles","Away",27,33,-6,91459
"1323",2015,9,"San Diego Chargers","Chicago Bears","Away",19,22,-3,52402
"1324",2015,10,"New York Jets","Buffalo Bills","Away",17,22,-5,78160
"1325",2015,10,"St. Louis Rams","Chicago Bears","Away",13,37,-24,NA
"1326",2015,10,"Tennessee Titans","Carolina Panthers","Away",10,27,-17,62304
"1327",2015,10,"Green Bay Packers","Detroit Lions","Away",16,18,-2,78413
"1328",2015,10,"Pittsburgh Steelers","Cleveland Browns","Home",30,9,21,64356
"1329",2015,10,"Baltimore Ravens","Jacksonville Jaguars","Away",20,22,-2,71002
"1330",2015,10,"Tampa Bay Buccaneers","Dallas Cowboys","Home",10,6,4,61560
"1331",2015,10,"Philadelphia Eagles","Miami Dolphins","Away",19,20,-1,69483
"1332",2015,10,"Washington Redskins","New Orleans Saints","Home",47,14,33,76209
"1333",2015,10,"Oakland Raiders","Minnesota Vikings","Away",14,30,-16,54613
"1334",2015,10,"Denver Broncos","Kansas City Chiefs","Away",13,29,-16,76922
"1335",2015,10,"New York Giants","New England Patriots","Away",26,27,-1,79001
"1336",2015,10,"Seattle Seahawks","Arizona Cardinals","Away",32,39,-7,69020
"1337",2015,10,"Cincinnati Bengals","Houston Texans","Away",6,10,-4,61389
"1338",2015,11,"Jacksonville Jaguars","Tennessee Titans","Home",19,13,6,61463
"1339",2015,11,"Philadelphia Eagles","Tampa Bay Buccaneers","Away",17,45,-28,69483
"1340",2015,11,"Baltimore Ravens","St. Louis Rams","Home",16,13,3,71002
"1341",2015,11,"Chicago Bears","Denver Broncos","Away",15,17,-2,62035
"1342",2015,11,"Atlanta Falcons","Indianapolis Colts","Away",21,24,-3,70355
"1343",2015,11,"Carolina Panthers","Washington Redskins","Home",44,16,28,74056
"1344",2015,11,"Detroit Lions","Oakland Raiders","Home",18,13,5,61347
"1345",2015,11,"Houston Texans","New York Jets","Home",24,17,7,71769
"1346",2015,11,"Miami Dolphins","Dallas Cowboys","Away",14,24,-10,67193
"1347",2015,11,"San Diego Chargers","Kansas City Chiefs","Away",3,33,-30,52402
"1348",2015,11,"Minnesota Vikings","Green Bay Packers","Away",13,30,-17,52430
"1349",2015,11,"Seattle Seahawks","San Francisco 49ers","Home",29,13,16,69020
"1350",2015,11,"Arizona Cardinals","Cincinnati Bengals","Home",34,31,3,64185
"1351",2015,11,"New England Patriots","Buffalo Bills","Home",20,13,7,66829
"1352",2015,12,"Detroit Lions","Philadelphia Eagles","Home",45,14,31,61347
"1353",2015,12,"Dallas Cowboys","Carolina Panthers","Away",14,33,-19,91459
"1354",2015,12,"Green Bay Packers","Chicago Bears","Away",13,17,-4,78413
"1355",2015,12,"New York Jets","Miami Dolphins","Home",38,20,18,78160
"1356",2015,12,"Tennessee Titans","Oakland Raiders","Away",21,24,-3,62304
"1357",2015,12,"Houston Texans","New Orleans Saints","Home",24,6,18,71769
"1358",2015,12,"Indianapolis Colts","Tampa Bay Buccaneers","Home",25,12,13,66047
"1359",2015,12,"Atlanta Falcons","Minnesota Vikings","Away",10,20,-10,70355
"1360",2015,12,"Cincinnati Bengals","St. Louis Rams","Home",31,7,24,61389
"1361",2015,12,"Washington Redskins","New York Giants","Home",20,14,6,76209
"1362",2015,12,"Kansas City Chiefs","Buffalo Bills","Home",30,22,8,74086
"1363",2015,12,"Jacksonville Jaguars","San Diego Chargers","Away",25,31,-6,61463
"1364",2015,12,"San Francisco 49ers","Arizona Cardinals","Away",13,19,-6,70799
"1365",2015,12,"Seattle Seahawks","Pittsburgh Steelers","Home",39,30,9,69020
"1366",2015,12,"Denver Broncos","New England Patriots","Home",30,24,6,76922
"1367",2015,12,"Cleveland Browns","Baltimore Ravens","Away",27,33,-6,66186
"1368",2015,13,"Detroit Lions","Green Bay Packers","Away",23,27,-4,61347
"1369",2015,13,"St. Louis Rams","Arizona Cardinals","Away",3,27,-24,NA
"1370",2015,13,"Tennessee Titans","Jacksonville Jaguars","Home",42,39,3,62304
"1371",2015,13,"Chicago Bears","San Francisco 49ers","Away",20,26,-6,62035
"1372",2015,13,"Buffalo Bills","Houston Texans","Home",30,21,9,69880
"1373",2015,13,"Minnesota Vikings","Seattle Seahawks","Away",7,38,-31,52430
"1374",2015,13,"Tampa Bay Buccaneers","Atlanta Falcons","Home",23,19,4,61560
"1375",2015,13,"Cleveland Browns","Cincinnati Bengals","Away",3,37,-34,66186
"1376",2015,13,"Miami Dolphins","Baltimore Ravens","Home",15,13,2,67193
"1377",2015,13,"New York Giants","New York Jets","Away",20,23,-3,79001
"1378",2015,13,"San Diego Chargers","Denver Broncos","Away",3,17,-14,52402
"1379",2015,13,"Oakland Raiders","Kansas City Chiefs","Away",20,34,-14,54613
"1380",2015,13,"New Orleans Saints","Carolina Panthers","Away",38,41,-3,73038
"1381",2015,13,"New England Patriots","Philadelphia Eagles","Away",28,35,-7,66829
"1382",2015,13,"Pittsburgh Steelers","Indianapolis Colts","Home",45,10,35,64356
"1383",2015,13,"Washington Redskins","Dallas Cowboys","Away",16,19,-3,76209
"1384",2015,14,"Arizona Cardinals","Minnesota Vikings","Home",23,20,3,64185
"1385",2015,14,"Philadelphia Eagles","Buffalo Bills","Home",23,20,3,69483
"1386",2015,14,"Tampa Bay Buccaneers","New Orleans Saints","Away",17,24,-7,61560
"1387",2015,14,"New York Jets","Tennessee Titans","Home",30,8,22,78160
"1388",2015,14,"Baltimore Ravens","Seattle Seahawks","Away",6,35,-29,71002
"1389",2015,14,"Chicago Bears","Washington Redskins","Away",21,24,-3,62035
"1390",2015,14,"Jacksonville Jaguars","Indianapolis Colts","Home",51,16,35,61463
"1391",2015,14,"Cincinnati Bengals","Pittsburgh Steelers","Away",20,33,-13,61389
"1392",2015,14,"St. Louis Rams","Detroit Lions","Home",21,14,7,NA
"1393",2015,14,"Cleveland Browns","San Francisco 49ers","Home",24,10,14,66186
"1394",2015,14,"Carolina Panthers","Atlanta Falcons","Home",38,0,38,74056
"1395",2015,14,"Kansas City Chiefs","San Diego Chargers","Home",10,3,7,74086
"1396",2015,14,"Denver Broncos","Oakland Raiders","Away",12,15,-3,76922
"1397",2015,14,"Green Bay Packers","Dallas Cowboys","Home",28,7,21,78413
"1398",2015,14,"Houston Texans","New England Patriots","Away",6,27,-21,71769
"1399",2015,14,"Miami Dolphins","New York Giants","Away",24,31,-7,67193
"1400",2015,15,"St. Louis Rams","Tampa Bay Buccaneers","Home",31,23,8,NA
"1401",2015,15,"Dallas Cowboys","New York Jets","Away",16,19,-3,91459
"1402",2015,15,"New York Giants","Carolina Panthers","Away",35,38,-3,79001
"1403",2015,15,"Minnesota Vikings","Chicago Bears","Home",38,17,21,52430
"1404",2015,15,"Indianapolis Colts","Houston Texans","Away",10,16,-6,66047
"1405",2015,15,"New England Patriots","Tennessee Titans","Home",33,16,17,66829
"1406",2015,15,"Jacksonville Jaguars","Atlanta Falcons","Away",17,23,-6,61463
"1407",2015,15,"Baltimore Ravens","Kansas City Chiefs","Away",14,34,-20,71002
"1408",2015,15,"Washington Redskins","Buffalo Bills","Home",35,25,10,76209
"1409",2015,15,"Oakland Raiders","Green Bay Packers","Away",20,30,-10,54613
"1410",2015,15,"Seattle Seahawks","Cleveland Browns","Home",30,13,17,69020
"1411",2015,15,"San Diego Chargers","Miami Dolphins","Home",30,14,16,52402
"1412",2015,15,"San Francisco 49ers","Cincinnati Bengals","Away",14,24,-10,70799
"1413",2015,15,"Pittsburgh Steelers","Denver Broncos","Home",34,27,7,64356
"1414",2015,15,"Philadelphia Eagles","Arizona Cardinals","Away",17,40,-23,69483
"1415",2015,15,"New Orleans Saints","Detroit Lions","Away",27,35,-8,73038
"1416",2015,16,"Oakland Raiders","San Diego Chargers","Home",23,20,3,54613
"1417",2015,16,"Philadelphia Eagles","Washington Redskins","Away",24,38,-14,69483
"1418",2015,16,"Atlanta Falcons","Carolina Panthers","Home",20,13,7,70355
"1419",2015,16,"Tennessee Titans","Houston Texans","Away",6,34,-28,62304
"1420",2015,16,"Baltimore Ravens","Pittsburgh Steelers","Home",20,17,3,71002
"1421",2015,16,"Buffalo Bills","Dallas Cowboys","Home",16,6,10,69880
"1422",2015,16,"Miami Dolphins","Indianapolis Colts","Away",12,18,-6,67193
"1423",2015,16,"New York Jets","New England Patriots","Home",26,20,6,78160
"1424",2015,16,"Detroit Lions","San Francisco 49ers","Home",32,17,15,61347
"1425",2015,16,"Kansas City Chiefs","Cleveland Browns","Home",17,13,4,74086
"1426",2015,16,"Tampa Bay Buccaneers","Chicago Bears","Away",21,26,-5,61560
"1427",2015,16,"New Orleans Saints","Jacksonville Jaguars","Home",38,27,11,73038
"1428",2015,16,"Arizona Cardinals","Green Bay Packers","Home",38,8,30,64185
"1429",2015,16,"Seattle Seahawks","St. Louis Rams","Away",17,23,-6,69020
"1430",2015,16,"Minnesota Vikings","New York Giants","Home",49,17,32,52430
"1431",2015,16,"Denver Broncos","Cincinnati Bengals","Home",20,17,3,76922
"1432",2015,17,"Chicago Bears","Detroit Lions","Away",20,24,-4,62035
"1433",2015,17,"Indianapolis Colts","Tennessee Titans","Home",30,24,6,66047
"1434",2015,17,"Cincinnati Bengals","Baltimore Ravens","Home",24,16,8,61389
"1435",2015,17,"Atlanta Falcons","New Orleans Saints","Away",17,20,-3,70355
"1436",2015,17,"Miami Dolphins","New England Patriots","Home",20,10,10,67193
"1437",2015,17,"Houston Texans","Jacksonville Jaguars","Home",30,6,24,71769
"1438",2015,17,"Cleveland Browns","Pittsburgh Steelers","Away",12,28,-16,66186
"1439",2015,17,"Buffalo Bills","New York Jets","Home",22,17,5,69880
"1440",2015,17,"Dallas Cowboys","Washington Redskins","Away",23,34,-11,91459
"1441",2015,17,"New York Giants","Philadelphia Eagles","Away",30,35,-5,79001
"1442",2015,17,"Denver Broncos","San Diego Chargers","Home",27,20,7,76922
"1443",2015,17,"San Francisco 49ers","St. Louis Rams","Home",19,16,3,70799
"1444",2015,17,"Carolina Panthers","Tampa Bay Buccaneers","Home",38,10,28,74056
"1445",2015,17,"Arizona Cardinals","Seattle Seahawks","Away",6,36,-30,64185
"1446",2015,17,"Kansas City Chiefs","Oakland Raiders","Home",23,17,6,74086
"1447",2015,17,"Green Bay Packers","Minnesota Vikings","Away",13,20,-7,78413
"1448",2015,NA,NA,NA,NA,NA,NA,NA,NA
"1449",2015,NA,"Houston Texans","Kansas City Chiefs","Away",0,30,-30,71769
"1450",2015,NA,"Cincinnati Bengals","Pittsburgh Steelers","Away",16,18,-2,61389
"1451",2015,NA,"Minnesota Vikings","Seattle Seahawks","Away",9,10,-1,52430
"1452",2015,NA,"Washington Redskins","Green Bay Packers","Away",18,35,-17,76209
"1453",2015,NA,"New England Patriots","Kansas City Chiefs","Home",27,20,7,66829
"1454",2015,NA,"Arizona Cardinals","Green Bay Packers","Home",26,20,6,64185
"1455",2015,NA,"Carolina Panthers","Seattle Seahawks","Home",31,24,7,74056
"1456",2015,NA,"Denver Broncos","Pittsburgh Steelers","Home",23,16,7,76922
"1457",2015,NA,"Denver Broncos","New England Patriots","Home",20,18,2,76922
"1458",2015,NA,"Carolina Panthers","Arizona Cardinals","Home",49,15,34,74056
"1459",2015,NA,"Carolina Panthers","Denver Broncos","Away",10,24,-14,74056
